.... You are floating in the middle of a tropical ocean.  You hoped that the cruise ship would notice you were missing, but it's been hours, and no ship has appeared on the horizon.

Alien Shores....
An Interactive Fiction by Keith B Phillips....Say look, or north, east, west south to move.
Release 1 / Serial number 181014 / Inform 7 build 6M62 (I6/v6.33 lib 6/12N) SD

Ocean Waves
....  You lay on your back in the warm water as your body floats up and down the rythmic waves. The hot sun beats down on you and there is not a cloud in the clear blue sky.

What next?  You can say, help, to get more information on how to play.

I beg your pardon?

* * *

>Hi
That's not a verb I recognise.

What now?

>look
Ocean Waves
 You lay on your back in the warm water as the waves lift your body up and down rythmically.  The sun's relentless heat beats down on you and the salt spray stings your eyes. The sea laps against your face and sometimes over it.  When it does, you spout like a tiny human whale. 

What now?

* * *

>burn ocean
You must supply a second noun.

You deeply regret trying to stop your phone from falling over the railing of the ship. Now look what's happened.

What next?  You can say, help, to get more information on how to play.

>light ocean
You must supply a second noun.

This really sucks. You could be kicking back right now having an ice-cold drink in the ship's lounge.

What next?  You can say, help, to get more information on how to play.

>get bug
Rippling Waves (on the piece of wood)
....  You are sitting on a rough board about six feet in length. All around you is ocean and sky.

White Sand Beach
.... You are on a beautiful island beach. To the east there is nothing but ocean for as far as the eye can see. This white sand beach extends north and south.  To the west is a lush jungle of green vegetation.

....  You continue to swim and are getting tired.  There is a stick of very wet driftwood here, about six feet long and and three inches thick.

You can also see a jacket, a piece of wood and a palm tree here.

You can't reach into Rippling Waves.

Your stomach aches with hunger. You better find something to eat soon.

What next?  You can say, help, to get more information on how to play.

>w
Animal Trail
.... Under the thick canopy of trees large leafed plants gather what sunlight they can. Dead branches litter the ground. Some kind of animals have beaten down a narrow path between the vegetation.  The path leads west into the jungle and east to the White Sand Beach.

You can see Branches here.

What next?  You can say, help, to get more information on how to play.

>get branches
You walk around stomping on the branches and breaking them up into smaller pieces.  Soon you have gathered up an armload of useable firewood.

What next? :

>e
White Sand Beach
.... You are on a beautiful island beach. To the east there is nothing but ocean for as far as the eye can see. This white sand beach extends north and south.  To the west is a lush jungle of green vegetation.

....  You continue to swim and are getting tired.  There is a stick of very wet driftwood here, about six feet long and and three inches thick.

You can also see a jacket, a piece of wood and a palm tree here.

What next? :

>get matches
Taken.

What next? :

>burn firewood
You must supply a second noun.

What next? :

* * *

>burn wood
You can't see any such thing.

What next?  You can say, help, to get more information on how to play.

>w
Rippling Waves
....  You see a piece of wood about six feet in length. You swim over and cling to it gratefully. You look at the wood, and a surge of hope goes through you. This is actually a wide board that has been roughly hewn from a log.

You can see a piece of wood here.

You deeply regret trying to stop your phone from falling over the railing of the ship. Now look what's happened.

What next?  You can say, help, to get more information on how to play.

>burn wood
You must supply a second noun.

This really sucks. You could be kicking back right now having an ice-cold drink in the ship's lounge.

What next? :

>e
Ocean Waves
....  You lay on your back in the warm water as your body floats up and down the rythmic waves. The hot sun beats down on you and there is not a cloud in the clear blue sky.

You can see a bug here.

At least one good thing has come of all this, you won't have to worry about ending your vacation any time soon.

What next? :

>get bug
Rippling Waves (on the piece of wood)
....  You are sitting on a rough board about six feet in length. All around you is ocean and sky.

White Sand Beach
.... You are on a beautiful island beach. To the east there is nothing but ocean for as far as the eye can see. This white sand beach extends north and south.  To the west is a lush jungle of green vegetation.

....  You continue to swim and are getting tired.  There is a stick of very wet driftwood here, about six feet long and and three inches thick.

You can also see a jacket, a piece of wood and a palm tree here.

You can't reach into Rippling Waves.

Your stomach aches with hunger. You better find something to eat soon.

What next? :

>w
Animal Trail
.... Under the thick canopy of trees large leafed plants gather what sunlight they can. Dead branches litter the ground. Some kind of animals have beaten down a narrow path between the vegetation.  The path leads west into the jungle and east to the White Sand Beach.

You can see Branches here.

What next? :

>get branches
You walk around stomping on the branches and breaking them up into smaller pieces.  Soon you have gathered up an armload of useable firewood.

What next? :

* * *

>get matches
Taken.

What next? :

>burn wood
You must supply a second noun.

What next? :

>light wood
You must supply a second noun.

What next? :

>light firewood
You must supply a second noun.

What next? :

* * *

>e
Open Water
 You swim to stay afloat. All that at effort is making you really tired. If only you had something to float on. Nothing but more ocean can be seen in all directions.

You must have hit your head against the ship during the fall.  A small raised lump on the back of your skull is throbbing.

>n
Even More Open Water
 You tread water to stay afloat. You're getting tired.  There is a stick of very wet driftwood here, about six feet long and and one inch thick.

This really sucks. You could be kicking back having an ice-cold drink in the ship's lounge right now.

>l
Even More Open Water
 You tread water to stay afloat. You're getting tired.  A stick of very wet driftwood, about six feet long and and one inch thick.

>l
Even More Open Water
 You tread water to stay afloat. You're getting tired.  A stick of very wet driftwood, about six feet long and and one inch thick.

>l
Even More Open Water
 You tread water to stay afloat. You're getting tired.  A stick of very wet driftwood, about six feet long and and one inch thick.

You're getting so tired of treading water, and the waves are kicking up some in wind. You have to get out of the water soon.

>l
Even More Open Water
 You tread water to stay afloat. You're getting tired.  A stick of very wet driftwood, about six feet long and and one inch thick.

>l
Even More Open Water
 You tread water to stay afloat. You're getting tired.  A stick of very wet driftwood, about six feet long and and one inch thick.

You are suddenly exhausted, you try to resume floating on your back again, but the waves are higher now and sweep you under.  You reach for the surface as you sink into the gloom.

    *** You have drowned. ***

Would you like to RESTART, RESTORE a saved game, QUIT or UNDO the last command?

>restart
You are floating in the middle of a tropical ocean.  You hoped that the cruise ship would notice you were missing, but it's been hours and hours, and no ship has appeared on the horizon.

Alien Shores
An Interactive Fiction by Keith B Phillips
Release 1 / Serial number 180905 / Inform 7 build 6M62 (I6/v6.33 lib 6/12N) SD

Ocean Waves
 You lay on your back in the warm water as the waves lift your body up and down rythmically.

>w
Rippling Waves
 You see a piece of wood about six feet in length. You swim over and cling to it gratefully. You look at the wood, and a chill goes through you. This is actually a board that has been roughly hewn from log.

You can see a piece of wood here.

>l
Rippling Waves
 You see a piece of wood about six feet in length. You swim over and cling to it gratefully. You look at the wood, and a chill goes through you. This is actually a board that has been roughly hewn from log.

You can see a piece of wood here.

>l
Rippling Waves
 You see a piece of wood about six feet in length. You swim over and cling to it gratefully. You look at the wood, and a chill goes through you. This is actually a board that has been roughly hewn from log.

You can see a piece of wood here.

>e
Ocean Waves
 You lay on your back in the warm water as the waves lift your body up and down rythmically.

>l
Ocean Waves
 You lay on your back in the warm water as the waves lift your body up and down rythmically. 

You deeply regret trying to stop your phone from falling over the railing of the ship.  Now look what's happened.

>l
Ocean Waves
 You lay on your back in the warm water as the waves lift your body up and down rythmically.

>l
Ocean Waves
 You lay on your back in the warm water as the waves lift your body up and down rythmically.

>e
Open Water
 You tread water to stay afloat. You're getting tired. If only you had something to float on. Nothing but more water can be seen.

>l
Open Water
 You tread water to stay afloat. You're getting tired. If only you had something to float on. Nothing but more water can be seen.

>l
Open Water
 You tread water to stay afloat. You're getting tired. If only you had something to float on. Nothing but more water can be seen.

I beg your pardon?

>l
Open Water
 You tread water to stay afloat. You're getting tired. If only you had something to float on. Nothing but more water can be seen.

>n
Even More Open Water
 You tread water to stay afloat. You're getting tired.  A stick of very wet driftwood, about six feet long and and one inch thick.

>l
Even More Open Water
 You tread water to stay afloat. You're getting tired.  A stick of very wet driftwood, about six feet long and and one inch thick.

* * *

>n
Even More Open Water
 You tread water to stay afloat. You're getting tired.  There is a stick of very wet driftwood here, about six feet long and and one inch thick.

This really sucks. You could be kicking back having an ice-cold drink in the ship's lounge right now.

>n
You begin to paddle in that direction but without a plan or destination you soon lose hope and return.

Well, at least you won't have to worry about ending your vacation any time soon.

>w
Floating Object
 You tread water, and you are getting exhausted.  What is left of a human body floats on the surface here.  Something has been eating on it.

On the body is a jacket.

>n
You begin to paddle in that direction but without a plan or destination you soon lose hope and return.

>get jacket
You can't hold the jacket and swim. You can barely stay above water as it is.

>w
You begin to paddle in that direction but without a plan or destination you soon lose hope and return.

You're getting so tired, and the waves are kicking up some in wind. You have to get out of the water soon.

>s
Ocean Waves
 You lay on your back in the warm water as your body floats up and down the rythmic waves. The hot sun beats down on you and there is not a cloud in the clear blue sky.

>w
Rippling Waves
 You see a piece of wood about six feet in length. You swim over and cling to it gratefully. You look at the wood, and a surge of hope goes through you. This is actually a board that has been roughly hewn from a log.

You can see a piece of wood here.

>get on board
Thank goodness!  You were getting exhausted just trying to stay alfloat.

You mount the piece of wood.

>e
Ocean Waves (on the piece of wood)
 The water laps at the plank you sit on, rocking you up and down.  You can see a dark object bobbing on the surface to the North.

>n
Floating Object (on the piece of wood)
 What is left of a human body floats on the surface here.  Something has been eating on it.

On the body is a jacket.

>get jacket
The body is badly decayed. You can't tell if it was male or female.  Your stomach churns from the smell, but you grit your teeth and strip the jacket off.

>e
Even More Open Water (on the piece of wood)
 There is a stick of very wet driftwood here, about six feet long and and one inch thick.

>get jacket
You already have that.

>get stick
Taken.

>put the stick in the hole
You place the driftwood stick into the knothole. It's a tight fit, but you manage it. Your little plank surfboard now has a mast.

>put the jacket on the stick
You drape the jacket over the stick by the collar.
The wind catches the jacket and pulls you along over the waves.

Journeying On The Waves (on the piece of wood)
A brisk wind wind is blowing. The sun hangs low in the sky. In the distance you can barely make out the shape of an island jutting above the waves

You can see a sail here.

There is the faint outline of an island in the distance.

>l
Journeying On The Waves (on the piece of wood)
A brisk westward wind is blowing. The sun hangs low in the sky. You speed ahead toward the island as the wind catches your fancy jacket-sail.

You can see a centered positioned sail here.

There is the faint outline of an island in the distance.

>l
White Sand Beach (on the piece of wood)
You are on a beautiful island beach. To the east there is nothing but ocean for as far as the eye can see. This white sand beach extends north and south.  To the west is a lush jungle of green vegetation.

>n
You can't sail on land. You should probably get off the board.

>get off the board
You dismount the piece of wood.

White Sand Beach
You are on a beautiful island beach. To the east there is nothing but ocean for as far as the eye can see. This white sand beach extends north and south.  To the west is a lush jungle of green vegetation.

You can see a piece of wood here.

>n
North Beach
You are on the beach a little north from where you came ashore.  You can see your sailboard to the south. The palm trees whisper in the wind to the west in the lush jungle.

You can see a Sea Turtle here.

>look at the turtle
The Sea Turtle is about four feet around and has a colorful dark green shell. Her flippered legs propel her forward as she shuffles accross the beach toward a low sandy mound near the tree line to the west. She turns a large intelligent eye at you for a few seconds, but then continues laboring toward the mound.

>w
The Sea Turtle swivels quickly toward you, snapping its curved beak at the air inches from your exposed legs. You stagger back in fear for your life.

* * *

>n
Even More Open Water
 You tread water to stay afloat. You're getting tired.  There is a stick of very wet driftwood here, about six feet long and and one inch thick.

This really sucks. You could be kicking back having an ice-cold drink in the ship's lounge right now.

>s
You can't go that way.

>e
You can't go that way.

>w
Piece of Debri
You cling to the piece of wood.  It seems to have been part of a boat at one time.

>n
You can't go that way.

>s
You can't go that way.

>e
Open Water
You tread water.  Nothing but more water can be seen.

>e
You can't go that way.

>n
Small Floating Object
You see an human shape floating face down in the water.

There is a small wicker cage discarded nearby.

* * *

>n
Even More Open Water
 You tread water to stay afloat. You're getting tired.  There is a stick of very wet driftwood here, about six feet long and and one inch thick.

This really sucks. You could be kicking back having an ice-cold drink in the ship's lounge right now.

>w
Floating Object
 You tread water, and you are getting exhausted.  What is left of a human body floats on the surface here.  Something has been eating on it.

On the body is a jacket.

>ne
Even More Open Water
 You tread water to stay afloat. You're getting tired.  A stick of very wet driftwood, about six feet long and and one inch thick.

>get stick
You won't be able to swim while holding the very wet piece of driftwood.

>w
You begin to paddle in that direction but without a plan or destination you soon lose hope and return.

>w
You begin to paddle in that direction but without a plan or destination you soon lose hope and return.

>se
You begin to paddle in that direction but without a plan or destination you soon lose hope and return.

>sw
Ocean Waves
 You lay on your back in the warm water as the waves lift your body up and down rythmically.  The sun's relentless heat beats down on you and the salt spray stings your eyes. The sea laps against your face and sometimes over it.  When it does, you spout like a tiny human whale.

>w
Rippling Waves
You cling to a piece of wood.  It seems to have been part of a boat at one time..

>get on wood
You mount the piece of wood.

>e
Ocean Waves (on the piece of wood)
 The water laps at the plank you sit on, rocking you up and down.

>e
Open Water (on the piece of wood)
 Nothing but more water can be seen.

>w
Ocean Waves (on the piece of wood)
 The water laps at the plank you sit on, rocking you up and down.

>ne
Even More Open Water (on the piece of wood)
 A stick of very wet driftwood, about six feet long and and one inch thick.

>get stick
You won't be able to swim while holding the very wet piece of driftwood.

* * *

>w
Floating Object
 You tread water, and you are getting exhausted.  What is left of a human body floats on the surface here.  Something has been eating on it.

On the body is a jacket.

>s
Ocean Waves
 You lay on your back in the warm water as your body floats up and down the rythmic waves. The hot sun beats down on you and there is not a cloud in the clear blue sky.

>e
Open Water
 You tread water to stay above water. All that at effort is making you really tired. If only you had something to float on. Nothing but more water can be seen in all directions.

>n
Even More Open Water
 You tread water to stay afloat. You're getting tired.  There is a stick of very wet driftwood here, about six feet long and and one inch thick.

>w
Floating Object
 You tread water, and you are getting exhausted.  What is left of a human body floats on the surface here.  Something has been eating on it.

On the body is a jacket.

You're getting so tired of treading water, and the waves are kicking up some in wind. You have to get out of the water soon.

>s
Ocean Waves
 You lay on your back in the warm water as your body floats up and down the rythmic waves. The hot sun beats down on you and there is not a cloud in the clear blue sky.

* * *

>w
Rippling Waves
 You see a piece of wood about six feet in length. You swim over and cling to it gratefully. You look at the wood, and a surge of hope goes through you. This is actually a board that has been roughly hewn from a log.

You can see a piece of wood here.

>l
Rippling Waves
 You see a piece of wood about six feet in length. You swim over and cling to it gratefully. You look at the wood, and a surge of hope goes through you. This is actually a board that has been roughly hewn from a log.

You can see a piece of wood here.

>l
Rippling Waves
 You see a piece of wood about six feet in length. You swim over and cling to it gratefully. You look at the wood, and a surge of hope goes through you. This is actually a board that has been roughly hewn from a log.

You can see a piece of wood here.

>e
Ocean Waves
 You lay on your back in the warm water as your body floats up and down the rythmic waves. The hot sun beats down on you and there is not a cloud in the clear blue sky.

>l
Ocean Waves
 You lay on your back in the warm water as your body floats up and down the rythmic waves. The hot sun beats down on you and there is not a cloud in the clear blue sky.

>l
Ocean Waves
 You lay on your back in the warm water as your body floats up and down the rythmic waves. The hot sun beats down on you and there is not a cloud in the clear blue sky.

>e
Open Water
 You tread water to stay above water. All that at effort is making you really tired. If only you had something to float on. Nothing but more water can be seen in all directions.

>l
Open Water
 You tread water to stay above water. All that at effort is making you really tired. If only you had something to float on. Nothing but more water can be seen in all directions.

>l
Open Water
 You tread water to stay above water. All that at effort is making you really tired. If only you had something to float on. Nothing but more water can be seen in all directions.

>l
Open Water
 You tread water to stay above water. All that at effort is making you really tired. If only you had something to float on. Nothing but more water can be seen in all directions.

You are suddenly exhausted, you try to resume floating on your back again, but the waves are higher now and sweep you under.  You reach for the surface as you sink into the gloom.

    *** You have drowned. ***

Would you like to RESTART, RESTORE a saved game, QUIT or UNDO the last command?

* * *

>e
Open Water
 You swim to stay afloat. All that at effort is making you really tired. If only you had something to float on. Nothing but more ocean can be seen in all directions.

You must have hit your head against the ship during the fall.  A small raised lump on the back of your skull is throbbing.

>s
You begin to paddle in that direction but without a plan or destination you soon lose hope and return.

>e
You begin to paddle in that direction but without a plan or destination you soon lose hope and return.

>n
Even More Open Water
 You tread water to stay afloat. You're getting tired.  There is a stick of very wet driftwood here, about six feet long and and one inch thick.

>w
Floating Object
 You tread water, and you are getting exhausted.  What is left of a human body floats on the surface here.  Something has been eating on it.

On the body is a jacket.

>e
Even More Open Water
 You tread water to stay afloat. You're getting tired.  There is a stick of very wet driftwood here, about six feet long and and one inch thick.

>n
You begin to paddle in that direction but without a plan or destination you soon lose hope and return.

You're getting so tired of treading water, and the waves are kicking up some in wind. You have to get out of the water soon.

>e
You begin to paddle in that direction but without a plan or destination you soon lose hope and return.

>s
Open Water
 You tread water to stay above water. All that at effort is making you really tired. If only you had something to float on. Nothing but more water can be seen in all directions.

You are suddenly exhausted, you try to resume floating on your back again, but the waves are higher now and sweep you under.  You reach for the surface as you sink into the gloom.

    *** You have drowned. ***

Would you like to RESTART, RESTORE a saved game, QUIT or UNDO the last command?

* * *

>e
You begin to paddle in that direction but without a plan or destination you soon lose hope and return.

>w
Ocean Waves
 You lay on your back in the warm water as your body floats up and down the rythmic waves. The hot sun beats down on you and there is not a cloud in the clear blue sky.

* * *

>e
Open Water
 You swim to stay afloat. All that at effort is making you really tired. If only you had something to float on. Nothing but more ocean can be seen in all directions.

You must have hit your head against the ship during the fall.  A small raised lump on the back of your skull is throbbing.

>w
Ocean Waves
 You lay on your back in the warm water as the waves lift your body up and down rythmically.

>w
Rippling Waves
 You see a piece of wood about six feet in length. You swim over and cling to it gratefully. You look at the wood, and a surge of hope goes through you. This is actually a board that has been roughly hewn from log.

You can see a piece of wood here.

>get on the board
Thank goodness!  You were getting exhausted just trying to stay alfloat.

You mount the piece of wood.

>ne
Floating Object (on the piece of wood)
 A body seems to have been the source of a partial meal.

On the body is a jacket.

>get jacket
The body is badly decayed. You can't tell if it was male or female.  Your stomach churns from the smell, but you grit your teeth and strip the jacket off.

>e
Even More Open Water (on the piece of wood)
 A stick of very wet driftwood, about six feet long and and one inch thick.

>get sick
You can't see any such thing.

>get stick
Taken.

>put stick in hole
You place the driftwood stick into the knothole. It's a tight fit, but you manage it. Your little plank surfboard now has a mast.

>put jacket on stick
You drape the jacket over the stick by the collar.
The wind catches the jacket and pulls you along over the waves.

Rushing Waves (on the piece of wood)
You rush along the tops of the waves as a westward wind blows your makeshift sail.  The sail is in the center position and the wind fills it nicely. The board is slippery and wet and hits the occasional wave just so, sending a spray into your face, almost knocking you from the board. You cling to the fragile looking stick of driftwood desperately hoping that it will hold and keep you on the board.

>l
Rushing Waves (on the piece of wood)
You rush along the tops of the waves as a westward wind blows your makeshift sail.  The sail is in the center position and the wind fills it nicely. The board is slippery and wet and hits the occasional wave just so, sending a spray into your face, almost knocking you from the board. You cling to the fragile looking stick of driftwood desperately hoping that it will hold and keep you on the board.

>l
Journeying On The Waves (on the piece of wood)
A brisk wind wind is blowing. The sun hangs low in the sky. In the distance you can barely make out the shape of an island jutting above the waves

You can see a sail here.

There is the faint outline of an island in the distance.

>l
Journeying On The Waves (on the piece of wood)
A brisk westward wind is blowing. The sun hangs low in the sky. You speed ahead toward the island as the wind catches your fancy jacket-sail.

You can see a centered positioned sail here.

The wind suddenly shifts to the westward! You speed ahead toward the island as the wind catches your fancy jacket-sail.There is the faint outline of an island in the distance.

>l
Journeying On The Waves (on the piece of wood)
A brisk westward wind is blowing. The sun hangs low in the sky. You speed ahead toward the island as the wind catches your fancy jacket-sail.

You can see a centered positioned sail here.

There is the faint outline of an island in the distance.

>l
Journeying On The Waves (on the piece of wood)
A brisk southwestward wind is blowing. The sun hangs low in the sky. Your speed toward the island has slowed to a crawl.

You can see a centered positioned sail here.

There is the faint outline of an island in the distance.

>l
Journeying On The Waves (on the piece of wood)
A brisk southwestward wind is blowing. The sun hangs low in the sky. Your speed toward the island has slowed to a crawl.

You can see a centered positioned sail here.

The wind suddenly shifts to the southwestward! Your speed toward the island has slowed to a crawl.There is the faint outline of an island in the distance.

>l
Journeying On The Waves (on the piece of wood)
A brisk southwestward wind is blowing. The sun hangs low in the sky. Your speed toward the island has slowed to a crawl.

You can see a centered positioned sail here.

The wind suddenly shifts to the westward! You speed ahead toward the island as the wind catches your fancy jacket-sail.

>l
Journeying On The Waves (on the piece of wood)
A brisk westward wind is blowing. The sun hangs low in the sky. You speed ahead toward the island as the wind catches your fancy jacket-sail.

You can see a centered positioned sail here.

>l
Journeying On The Waves (on the piece of wood)
A brisk northwestward wind is blowing. The sun hangs low in the sky. Your speed toward the island has slowed to a crawl.

You can see a centered positioned sail here.

>l
Journeying On The Waves (on the piece of wood)
A brisk northwestward wind is blowing. The sun hangs low in the sky. Your speed toward the island has slowed to a crawl.

You can see a centered positioned sail here.

The wind suddenly shifts to the northwestward! Your speed toward the island has slowed to a crawl.

>l
Journeying On The Waves (on the piece of wood)
A brisk northwestward wind is blowing. The sun hangs low in the sky. Your speed toward the island has slowed to a crawl.

You can see a centered positioned sail here.

The wind suddenly shifts to the northwestward! Your speed toward the island has slowed to a crawl.

>l
Journeying On The Waves (on the piece of wood)
A brisk northwestward wind is blowing. The sun hangs low in the sky. Your speed toward the island has slowed to a crawl.

You can see a centered positioned sail here.

>l
Journeying On The Waves (on the piece of wood)
A brisk southwestward wind is blowing. The sun hangs low in the sky. Your speed toward the island has slowed to a crawl.

You can see a centered positioned sail here.

The wind suddenly shifts to the southwestward! Your speed toward the island has slowed to a crawl.
A grey fin emerges from the waves.  Your adrenaline kicks in, but you manage to hold yourself together.  You guide your make-shift sailboard away from it until the fin submerges.

>l
Journeying On The Waves (on the piece of wood)
A brisk southwestward wind is blowing. The sun hangs low in the sky. Your speed toward the island has slowed to a crawl.

You can see a centered positioned sail here.

The wind suddenly shifts to the southwestward! Your speed toward the island has slowed to a crawl.

>l
Journeying On The Waves (on the piece of wood)
A brisk southwestward wind is blowing. The sun hangs low in the sky. Your speed toward the island has slowed to a crawl.

You can see a centered positioned sail here.

The wind suddenly shifts to the northwestward! Your speed toward the island has slowed to a crawl.

>l
Journeying On The Waves (on the piece of wood)
A brisk northwestward wind is blowing. The sun hangs low in the sky. Your speed toward the island has slowed to a crawl.

You can see a centered positioned sail here.

The island is getting closer.

>l
Journeying On The Waves (on the piece of wood)
A brisk westward wind is blowing. The sun hangs low in the sky. You speed ahead toward the island as the wind catches your fancy jacket-sail.

You can see a centered positioned sail here.

The island is getting closer.

>l
Journeying On The Waves (on the piece of wood)
A brisk westward wind is blowing. The sun hangs low in the sky. You speed ahead toward the island as the wind catches your fancy jacket-sail.

You can see a centered positioned sail here.

A grey fin emerges from the waves.  You frantically try to swerve away from it with your make-shift sail boat, but the shark is too quick.  Eons of evolution has turned it into the perfect predator.  It smells your fear and in the blink of an eye it's over.

    *** You have been eaten. ***

Would you like to RESTART, RESTORE a saved game, QUIT or UNDO the last command?

* * *

>exit
But you aren't in anything at the moment.

You deeply regret trying to stop your phone from falling over the railing of the ship. Now look what's happened.

What next?  You can say, help, to get more information on how to play.

>exit
But you aren't in anything at the moment.

This really sucks. You could be kicking back right now having an ice-cold drink in the ship's lounge.

What next?  You can say, help, to get more information on how to play.

* * *

>get bug
Rippling Waves (on the piece of wood)
....  You are sitting on a rough board about six feet in length. All around you is ocean and sky.

White Sand Beach
.... You are on a beautiful island beach. To the east there is nothing but ocean for as far as the eye can see. The beach extends north and south.  To the west is a lush jungle of green vegetation.

You can see a stick, a jacket, a piece of wood and a palm tree here.

You can't reach into Rippling Waves.

Your stomach aches with hunger. You better find something to eat soon.

What next?  You can say, help, to get more information on how to play.

>get knife
Taken.

What next? :

>s
South Beach
.... You are on the beach a little south from where you came ashore.  You can see your sailboard to the north. The surf washes over the sand with a sigh and hiss. The jungle is to the west and there is a little pool of water to the west from which a narrow stream of water flows out into the ocean.

What next? :

>w
Lagoon
.... There is a small pool of water about twenty feet in diameter here. It appears to be fed by a stream flowing out of the jungle in the west. The water is so crystal clear that you can easily see the bottom. In the pool, several fish of varying sizes and spectacular colors swim leisurely about in the warm water.

You can see a pool (in which are a yellow fish, a speckled fish and a striped fish) here.

What next? :

>w
Trickling Stream
A little stream flows out from the jungle here. The banks are lined with thin saplings and the vegetation is so thick that the only way further to go further west is to wade into the steam.

You can see Saplings here.

What next? :

>cut sapling
(with the knife)
You cut one of the saplings down with your knife. The wood is green and the knife is thin. Your knife constantly gets stuck, but you eventually manage to cut through.  You sharpen one end of the cut sapling, and now have a functional spear.

What next? :

>cut the sapling with the spear
What next? :

>i
You are carrying:
  a spear
  a knife

What next? :

>cut the sapling
What do you want to cut Saplings with?

What next? :

>cut the sapling with the knife
You cut one of the saplings down with your knife. The wood is green and the knife is thin. Your knife constantly gets stuck, but you eventually manage to cut through.  You sharpen one end of the cut sapling, and now have a functional spear.

What next? :

>i
You are carrying:
  a spear
  a knife

What next? :

>restart
Are you sure you want to restart?

>y
.... You are floating in the middle of a tropical ocean.  You hoped that the cruise ship would notice you were missing, but it's been hours, and no ship has appeared on the horizon.

Alien Shores....
An Interactive Fiction by Keith B Phillips....Say look, or north, east, west south to move.
Release 1 / Serial number 180915 / Inform 7 build 6M62 (I6/v6.33 lib 6/12N) SD

Ocean Waves
....  You lay on your back in the warm water as your body floats up and down the rythmic waves. The hot sun beats down on you and there is not a cloud in the clear blue sky.

You can see a bug here.

What next?  You can say, help, to get more information on how to play.

>get bug
Rippling Waves (on the piece of wood)
....  You are sitting on a rough board about six feet in length. All around you is ocean and sky.

White Sand Beach
.... You are on a beautiful island beach. To the east there is nothing but ocean for as far as the eye can see. This white sand beach extends north and south.  To the west is a lush jungle of green vegetation.

....  You continue to swim and are getting tired.  There is a stick of very wet driftwood here, about six feet long and and three inches thick.

You can also see a jacket, a piece of wood and a palm tree here.

You can't reach into Rippling Waves.

Your stomach aches with hunger. You better find something to eat soon.

What next?  You can say, help, to get more information on how to play.

>get knife
Taken.

What next? :

* * *

>cut sapling
(with the knife)
You cut one of the saplings down with your knife. The wood is green and the knife is thin. Your knife constantly gets stuck, but you eventually manage to cut through.  You sharpen one end of the cut sapling, and now have a functional spear.

What next? :

I beg your pardon?

What next? :

>w
You can't go that way.

What next? :

>e
Lagoon
.... There is a small pool of water about twenty feet in diameter here. It appears to be fed by a stream flowing out of the jungle in the west. The water is so crystal clear that you can easily see the bottom. In the pool, several fish of varying sizes and spectacular colors swim leisurely about in the warm water.

You can see a pool (in which are a yellow fish, a speckled fish and a striped fish) here.

What next? :

>stab fish
Who do you mean, the yellow fish, the speckled fish or the striped fish?

What next? :

>stab yellow fish
You must supply a second noun.

What next? :

>stab the yellow fish with the spear
Good aim!  You expertly spear the fish through its middle.

What next? :

>stab fish
Who do you mean, the speckled fish, the striped fish or the yellow fish?

What next? :

>stab the speckled fish
You must supply a second noun.

What next? :

* * *

>cut sapling
(with the knife)
You cut one of the saplings down with your knife. The wood is green and the knife is thin. Your knife constantly gets stuck, but you eventually manage to cut through.  You sharpen one end of the cut sapling, and now have a functional spear.

What next? :

>e
Lagoon
.... There is a small pool of water about twenty feet in diameter here. It appears to be fed by a stream flowing out of the jungle in the west. The water is so crystal clear that you can easily see the bottom. In the pool, several fish of varying sizes and spectacular colors swim leisurely about in the warm water.

You can see a pool (in which are a yellow fish, a speckled fish and a striped fish) here.

What next? :

* * *

>stab yellow fish
You must supply a second noun.

What next? :

>stab yellow fish with the knife.
You can't stab the yellow fish with that!

What next? :

>stab the yellow fish
You must supply a second noun.

What next? :

>stab the yellow fish with the spear
Good aim!  You expertly spear the fish through its middle.

What next? :

* * *

>get off wood
You dismount the piece of wood.

White Sand Beach
.... You are on a beautiful island beach. To the east there is nothing but ocean for as far as the eye can see. This white sand beach extends north and south.  To the west is a lush jungle of green vegetation.

....  You continue to swim and are getting tired.  There is a stick of very wet driftwood here, about six feet long and and three inches thick.

You can also see a jacket, a piece of wood and a palm tree here.

What next?

>s
South Beach
.... You are on the beach a little south from where you came ashore.  You can see your sailboard to the north. The surf washes over the sand with a sigh and hiss. The jungle is to the west and there is a little pool of water to the west from which a narrow stream of water flows out into the ocean.

What next?

* * *

>l
White Sand Beach (on the piece of wood)
.... You are on a beautiful island beach. To the east there is nothing but ocean for as far as the eye can see. This white sand beach extends north and south.  To the west is a lush jungle of green vegetation.

....  There is a stick of very wet driftwood here, about six feet long and and three inches thick.

You can also see a jacket and a palm tree here.

What next?

>get off board
You dismount the piece of wood.

White Sand Beach
.... You are on a beautiful island beach. To the east there is nothing but ocean for as far as the eye can see. This white sand beach extends north and south.  To the west is a lush jungle of green vegetation.

....  You continue to swim and are getting tired.  There is a stick of very wet driftwood here, about six feet long and and three inches thick.

You can also see a jacket, a piece of wood and a palm tree here.

What next?

>w
Animal Trail
.... Under the thick canopy of trees large leafed plants gather what sunlight they can. Dead branches litter the ground. Some kind of animals have beaten down a narrow path between the vegetation.  The path leads west into the jungle and east to the White Sand Beach.

You can see Branches here.

What next?

>e
White Sand Beach
.... You are on a beautiful island beach. To the east there is nothing but ocean for as far as the eye can see. This white sand beach extends north and south.  To the west is a lush jungle of green vegetation.

....  You continue to swim and are getting tired.  There is a stick of very wet driftwood here, about six feet long and and three inches thick.

You can also see a jacket, a piece of wood and a palm tree here.

What next?

>s
South Beach
.... You are on the beach a little south from where you came ashore.  You can see your sailboard to the north. The surf washes over the sand with a sigh and hiss. The jungle is to the west and there is a little pool of water to the west from which a narrow stream of water flows out into the ocean.

What next?

>w
Lagoon
.... There is a small pool of water about twenty feet in diameter here. It appears to be fed by a stream flowing out of the jungle in the west. The water is so crystal clear that you can easily see the bottom. In the pool, several fish of varying sizes and spectacular colors swim leisurely about in the warm water.

You can see a pool (in which are a yellow fish, a speckled fish and a striped fish) here.

What next?

>w
Trickling Stream
A little stream flows out from the jungle here. The banks are lines with thin saplings and the vegetation is so thick that the only way further to go further west is to wade into steam.

You can see Saplings, Firewood and a spear here.

What next?

* * *

>l
White Sand Beach (on the piece of wood)
.... You are on a beautiful island beach. To the east there is nothing but ocean for as far as the eye can see. This white sand beach extends north and south.  To the west is a lush jungle of green vegetation.

....  There is a stick of very wet driftwood here, about six feet long and and three inches thick.

You can also see a jacket and a palm tree here.

What next?

>look at wood
It's a sturdy wide plank with a round knothole in the middle of it.

What next?

>s
You can't sail on land. You should probably get off the board.

What next?

>get off wood
You dismount the piece of wood.

White Sand Beach
.... You are on a beautiful island beach. To the east there is nothing but ocean for as far as the eye can see. This white sand beach extends north and south.  To the west is a lush jungle of green vegetation.

....  You continue to swim and are getting tired.  There is a stick of very wet driftwood here, about six feet long and and three inches thick.

You can also see a jacket, a piece of wood and a palm tree here.

What next?

* * *

>w
Lagoon
.... There is a small pool of water about twenty feet in diameter here. It appears to be fed by a stream flowing out of the jungle in the west. The water is so crystal clear that you can easily see the bottom. In the pool, several fish of varying sizes and spectacular colors swim leisurely about in the warm water.

You can see a pool (in which are a yellow fish, a speckled fish and a striped fish) here.

What next?

>e
South Beach
.... You are on the beach a little south from where you came ashore.  You can see your sailboard to the north. The surf washes over the sand with a sigh and hiss. The jungle is to the west and there is a little pool of water to the west from which a narrow stream of water flows out into the ocean.

What next?

>n
White Sand Beach
.... You are on a beautiful island beach. To the east there is nothing but ocean for as far as the eye can see. This white sand beach extends north and south.  To the west is a lush jungle of green vegetation.

....  You continue to swim and are getting tired.  There is a stick of very wet driftwood here, about six feet long and and three inches thick.

You can also see a jacket, a piece of wood and a palm tree here.

What next?

>w
Animal Trail
.... Under the thick canopy of trees large leafed plants gather what sunlight they can. Dead branches litter the ground. Some kind of animals have beaten down a narrow path between the vegetation.  The path leads west into the jungle and east to the White Sand Beach.

You can see Branches here.

What next?

>get branches
You walk around stomping on the branches and breaking them up into smaller pieces.  Soon you have gathered up an armload of useable firewood.

What next?

>get branch
You couldn't possibly carry any more.

What next?

>l
Animal Trail
.... Under the thick canopy of trees large leafed plants gather what sunlight they can. Dead branches litter the ground. Some kind of animals have beaten down a narrow path between the vegetation.  The path leads west into the jungle and east to the White Sand Beach.

You can see Branches here.

What next?

>i
You are carrying:
  Firewood

What next?

>i
You are carrying:
  Firewood

What next?

I beg your pardon?

What next?

I beg your pardon?

What next?

>get branches
You couldn't possibly carry any more.

What next?

>l
Animal Trail
.... Under the thick canopy of trees large leafed plants gather what sunlight they can. Dead branches litter the ground. Some kind of animals have beaten down a narrow path between the vegetation.  The path leads west into the jungle and east to the White Sand Beach.

You can see Branches here.

What next?

* * *

>i
You are carrying:
  Firewood

What next?

>get branches
You couldn't possibly carry any more.

What next?

>i
You are carrying:
  Firewood

What next?

* * *

>get branches
You couldn't possibly carry any more.

What next?

>get branches
You couldn't possibly carry any more.

What next?

>e
White Sand Beach
.... You are on a beautiful island beach. To the east there is nothing but ocean for as far as the eye can see. This white sand beach extends north and south.  To the west is a lush jungle of green vegetation.

....  You continue to swim and are getting tired.  There is a stick of very wet driftwood here, about six feet long and and three inches thick.

You can also see a jacket, a piece of wood and a palm tree here.

What next?

* * *

>w
Lagoon
.... There is a small pool of water about twenty feet in diameter here. It appears to be fed by a stream flowing out of the jungle in the west. The water is so crystal clear that you can easily see the bottom. In the pool, several fish of varying sizes and spectacular colors swim leisurely about in the warm water.

You can see a pool (in which are a yellow fish, a speckled fish and a striped fish) here.

What next?

>get fish
Who do you mean, the yellow fish, the speckled fish or the striped fish?

What next?

>get the yellow fish
I don't suppose the yellow fish would care for that.

What next?

>examine yellow fish
This fish is silver on the bottom and has a light green back with a yellow stripe along its sides.

What next?

* * *

>s
South Beach
.... You are on the beach a little south from where you came ashore.  You can see your sailboard to the north. The surf washes over the sand with a sigh and hiss. The jungle is to the west and there is a little pool of water to the west from which a narrow stream of water flows out into the ocean.

What next? :

>get off wood
You dismount the piece of wood.

White Sand Beach
.... You are on a beautiful island beach. To the east there is nothing but ocean for as far as the eye can see. This white sand beach extends north and south.  To the west is a lush jungle of green vegetation.

....  You continue to swim and are getting tired.  There is a stick of very wet driftwood here, about six feet long and and three inches thick.

You can also see a jacket, a piece of wood and a palm tree here.

What next?

* * *

>w
Lagoon
.... There is a small pool of water about twenty feet in diameter here. It appears to be fed by a stream flowing out of the jungle in the west. The water is so crystal clear that you can easily see the bottom. In the pool, several fish of varying sizes and spectacular colors swim leisurely about in the warm water.

You can see a pool (in which are a yellow fish, a speckled fish and a striped fish) here.

What next?

>w
Trickling Stream
A little stream flows out from the jungle here. The banks are lines with thin saplings and the vegetation is so thick that the only way further to go further west is to wade into steam.

You can see Saplings here.

What next?

>cut sapling
You cut one of the saplings down with your knife. The wood is green and the knife is thin.  Your knife constantly gets stuck, but you eventually manage to cut through one.  A thought comes to you, and you sharpen one end of it.  You now have a functional spear.

What next?

>i
You are carrying:
  a spear

What next?

>e
Lagoon
.... There is a small pool of water about twenty feet in diameter here. It appears to be fed by a stream flowing out of the jungle in the west. The water is so crystal clear that you can easily see the bottom. In the pool, several fish of varying sizes and spectacular colors swim leisurely about in the warm water.

You can see a pool (in which are a yellow fish, a speckled fish and a striped fish) here.

What next?

>n
You can't go that way.

What next?

>e
South Beach
.... You are on the beach a little south from where you came ashore.  You can see your sailboard to the north. The surf washes over the sand with a sigh and hiss. The jungle is to the west and there is a little pool of water to the west from which a narrow stream of water flows out into the ocean.

What next?

* * *

>get branches
You walk around stomping on the branches and breaking them up into smaller pieces.  Soon you have gathered up an armload of useable firewood.

What next?

>i
You are carrying:
  Firewood
  a spear

What next?

>e
White Sand Beach
.... You are on a beautiful island beach. To the east there is nothing but ocean for as far as the eye can see. This white sand beach extends north and south.  To the west is a lush jungle of green vegetation.

....  You continue to swim and are getting tired.  There is a stick of very wet driftwood here, about six feet long and and three inches thick.

You can also see a jacket, a piece of wood and a palm tree here.

What next?

* * *

>w
Lagoon
.... There is a small pool of water about twenty feet in diameter here. It appears to be fed by a stream flowing out of the jungle in the west. The water is so crystal clear that you can easily see the bottom. In the pool, several fish of varying sizes and spectacular colors swim leisurely about in the warm water.

You can see a pool (in which are a yellow fish, a speckled fish and a striped fish) here.

What next?

>kill yellow fish with spear
I only understood you as far as wanting to kill the yellow fish.

What next?

>kill
What do you want to kill?

What next?

>kill yellow fish
Violence isn't the answer to this one.

What next?

I beg your pardon?

What next?

>attack the fish
Who do you mean, the yellow fish, the speckled fish or the striped fish?

What next?

>attach the yellow fish
What do you want to attach the yellow fish to?

What next?

>attack the yellow fish
Violence isn't the answer to this one.

What next?

>stab the fish with the spear
That's not a verb I recognise.

What next?

>stab the fish
That's not a verb I recognise.

What next?

>stab
That's not a verb I recognise.

What next?

>stab the fish
That's not a verb I recognise.

What next?

>stabing
That's not a verb I recognise.

What next?

>stab the yellow fish
That's not a verb I recognise.

What next?

>stab the yellow fish with the spear
That's not a verb I recognise.

What next?

* * *

>s
South Beach
.... You are on the beach a little south from where you came ashore.  You can see your sailboard to the north. The surf washes over the sand with a sigh and hiss. The jungle is to the west and there is a little pool of water to the west from which a narrow stream of water flows out into the ocean.

What next? :

>light the firewood
You can't see any such thing.

What next? :

>i
You are carrying nothing.

What next? :

>s
You can't go that way.

What next? :

>w
Lagoon
.... There is a small pool of water about twenty feet in diameter here. It appears to be fed by a stream flowing out of the jungle in the west. The water is so crystal clear that you can easily see the bottom. In the pool, several fish of varying sizes and spectacular colors swim leisurely about in the warm water.

You can see a pool (in which are a yellow fish, a speckled fish and a striped fish) here.

What next? :

>n
You can't go that way.

What next? :

>e
South Beach
.... You are on the beach a little south from where you came ashore.  You can see your sailboard to the north. The surf washes over the sand with a sigh and hiss. The jungle is to the west and there is a little pool of water to the west from which a narrow stream of water flows out into the ocean.

What next? :

>n
White Sand Beach
.... You are on a beautiful island beach. To the east there is nothing but ocean for as far as the eye can see. This white sand beach extends north and south.  To the west is a lush jungle of green vegetation.

....  You continue to swim and are getting tired.  There is a stick of very wet driftwood here, about six feet long and and three inches thick.

You can also see a jacket, a piece of wood and a palm tree here.

What next? :

>w
Animal Trail
.... Under the thick canopy of trees large leafed plants gather what sunlight they can. Dead branches litter the ground. Some kind of animals have beaten down a narrow path between the vegetation.  The path leads west into the jungle and east to the White Sand Beach.

You can see Branches here.

What next? :

* * *

>e
White Sand Beach
.... You are on a beautiful island beach. To the east there is nothing but ocean for as far as the eye can see. This white sand beach extends north and south.  To the west is a lush jungle of green vegetation.

....  You continue to swim and are getting tired.  There is a stick of very wet driftwood here, about six feet long and and three inches thick.

You can also see a jacket, a piece of wood and a palm tree here.

What next? :

>i
You are carrying:
  Firewood

What next? :

>light the firewood
This dangerous act would achieve little.

What next? :

* * *

>s
South Beach
.... You are on the beach a little south from where you came ashore.  You can see your sailboard to the north. The surf washes over the sand with a sigh and hiss. The jungle is to the west and there is a little pool of water to the west from which a narrow stream of water flows out into the ocean.

What next? :

>n
White Sand Beach
.... You are on a beautiful island beach. To the east there is nothing but ocean for as far as the eye can see. This white sand beach extends north and south.  To the west is a lush jungle of green vegetation.

You can see a stick, a jacket, a piece of wood and a palm tree here.

What next? :

>get knife
Taken.

What next? :

* * *

>w
Lagoon
.... There is a small pool of water about twenty feet in diameter here. It appears to be fed by a stream flowing out of the jungle in the west. The water is so crystal clear that you can easily see the bottom. In the pool, several fish of varying sizes and spectacular colors swim leisurely about in the warm water.

You can see a pool (in which are a yellow fish, a speckled fish and a striped fish) here.

What next? :

>w
Trickling Stream
A little stream flows out from the jungle here. The banks are lined with thin saplings and the vegetation is so thick that the only way further to go further west is to wade into the steam.

What next? :

>cut sapling
(with the knife)
You cut one of the saplings down with your knife. The wood is green and the knife is thin. Your knife constantly gets stuck, but you eventually manage to cut through.  You sharpen one end of the cut sapling, and now have a functional spear.

What next? :

>w
You can't go that way.

What next? :

* * *

>e
Lagoon
.... There is a small pool of water about twenty feet in diameter here. It appears to be fed by a stream flowing out of the jungle in the west. The water is so crystal clear that you can easily see the bottom. In the pool, several fish of varying sizes and spectacular colors swim leisurely about in the warm water.

You can see a pool (in which are a yellow fish, a speckled fish and a striped fish) here.

What next? :

>stab yellow fish
You must supply a second noun.

What next? :

>stab yellow fish with the spear
Good aim!  You expertly spear the fish through its middle.

What next? :

>e
South Beach
.... You are on the beach a little south from where you came ashore.  You can see your sailboard to the north. The surf washes over the sand with a sigh and hiss. The jungle is to the west and there is a little pool of water to the west from which a narrow stream of water flows out into the ocean.

What next? :

>n
White Sand Beach
.... You are on a beautiful island beach. To the east there is nothing but ocean for as far as the eye can see. This white sand beach extends north and south.  To the west is a lush jungle of green vegetation.

You can see a stick, a jacket, a piece of wood and a palm tree here.

What next? :

>w
Animal Trail
.... Under the thick canopy of trees large leafed plants gather what sunlight they can. Dead branches litter the ground. Some kind of animals have beaten down a narrow path between the vegetation.  The path leads west into the jungle and east to the White Sand Beach.

You can see Branches here.

What next? :

* * *

>get branches
You walk around stomping on the branches and breaking them up into smaller pieces.  Soon you have gathered up an armload of useable firewood.

What next? :

>e
White Sand Beach
.... You are on a beautiful island beach. To the east there is nothing but ocean for as far as the eye can see. This white sand beach extends north and south.  To the west is a lush jungle of green vegetation.

You can see a stick, a jacket, a piece of wood and a palm tree here.

What next? :

>light the firewood with the matches
You need someting to light the fire with.

What next? :

>get matches
You're carrying too many things already.

What next? :

>i
You are carrying:
  firewood
  a spear
    a yellow fish
  a knife

What next? :

>drop knife
Dropped.

What next? :

>get matches
You're carrying too many things already.

What next? :

>l
White Sand Beach
.... You are on a beautiful island beach. To the east there is nothing but ocean for as far as the eye can see. This white sand beach extends north and south.  To the west is a lush jungle of green vegetation.

You can see a knife, a stick, a jacket, a piece of wood and a palm tree here.

What next? :

>i
You are carrying:
  firewood
  a spear
    a yellow fish

What next? :

>drop firewood
Dropped.

What next? :

>light firewood with matches
You need someting to light the fire with.

What next? :

>get matches
Taken.

What next? :

>light firewood with matches
You take the branches that you collected and create a neat little pyramid of wood.  It takes three matches before it catches, but then a little cheerful fire begins to blossom, and the wood starts crackling.

What next? :

>cook fish
You lay the fish over the fire and flip it every few minutes until it is golden brown. The fragrant smells of cooked meat make you suddenly ravenous.

What next? :

>i
You are carrying:
  a book of matches
  a spear
    a cooked fish

What next? :

>i
You are carrying:
  a book of matches
  a spear
    a cooked fish

What next? :

I beg your pardon?

What next? :

>i
You are carrying:
  a book of matches
  a spear
    a cooked fish

What next? :

* * *

I beg your pardon?

What next? :

>eat fish
You consume the delicous meat of the cooked fish.  Your stomach is feeling full and content.

What next? :

>s
South Beach
.... You are on the beach a little south from where you came ashore.  You can see your sailboard to the north. The surf washes over the sand with a sigh and hiss. The jungle is to the west and there is a little pool of water to the west from which a narrow stream of water flows out into the ocean.

The fire is burning low and is about to go out.

What next? :

>w
Lagoon
.... There is a small pool of water about twenty feet in diameter here. It appears to be fed by a stream flowing out of the jungle in the west. The water is so crystal clear that you can easily see the bottom. In the pool, several fish of varying sizes and spectacular colors swim leisurely about in the warm water.

You can see a pool (in which are a speckled fish and a striped fish) here.

What next? :

>e
South Beach
.... You are on the beach a little south from where you came ashore.  You can see your sailboard to the north. The surf washes over the sand with a sigh and hiss. The jungle is to the west and there is a little pool of water to the west from which a narrow stream of water flows out into the ocean.

What next? :

>n
White Sand Beach
.... You are on a beautiful island beach. To the east there is nothing but ocean for as far as the eye can see. This white sand beach extends north and south.  To the west is a lush jungle of green vegetation.

You can see a dwindling fire, a knife, a stick, a jacket, a piece of wood and a palm tree here.

The fire has gone out.

What next? :

>get fire
You're carrying too many things already.

What next? :

>i
You are carrying:
  a book of matches
  a spear

What next? :

>s
South Beach
.... You are on the beach a little south from where you came ashore.  You can see your sailboard to the north. The surf washes over the sand with a sigh and hiss. The jungle is to the west and there is a little pool of water to the west from which a narrow stream of water flows out into the ocean.

What next? :

>w
Lagoon
.... There is a small pool of water about twenty feet in diameter here. It appears to be fed by a stream flowing out of the jungle in the west. The water is so crystal clear that you can easily see the bottom. In the pool, several fish of varying sizes and spectacular colors swim leisurely about in the warm water.

You can see a pool (in which are a speckled fish and a striped fish) here.

What next? :

>stab speckled fish with spear
Good aim!  You expertly spear the fish through its middle.

What next? :

>e
South Beach
.... You are on the beach a little south from where you came ashore.  You can see your sailboard to the north. The surf washes over the sand with a sigh and hiss. The jungle is to the west and there is a little pool of water to the west from which a narrow stream of water flows out into the ocean.

What next? :

>n
White Sand Beach
.... You are on a beautiful island beach. To the east there is nothing but ocean for as far as the eye can see. This white sand beach extends north and south.  To the west is a lush jungle of green vegetation.

You can see a pile of ashes, a knife, a stick, a jacket, a piece of wood and a palm tree here.

What next? :

>light firewood with matches
You can't see any such thing.

What next? :

>i
You are carrying:
  a book of matches
  a spear
    a speckled fish

What next? :

>l
White Sand Beach
.... You are on a beautiful island beach. To the east there is nothing but ocean for as far as the eye can see. This white sand beach extends north and south.  To the west is a lush jungle of green vegetation.

You can see a pile of ashes, a knife, a stick, a jacket, a piece of wood and a palm tree here.

What next? :

>get pile of ashes
You can't see any such thing.

What next? :

>get firewood
You can't see any such thing.

What next? :

>w
Animal Trail
.... Under the thick canopy of trees large leafed plants gather what sunlight they can. Dead branches litter the ground. Some kind of animals have beaten down a narrow path between the vegetation.  The path leads west into the jungle and east to the White Sand Beach.

You can see Branches here.

What next? :

* * *

>get branches
You walk around stomping on the branches and breaking them up into smaller pieces.  Soon you have gathered up an armload of useable firewood.

What next? :

>e
White Sand Beach
.... You are on a beautiful island beach. To the east there is nothing but ocean for as far as the eye can see. This white sand beach extends north and south.  To the west is a lush jungle of green vegetation.

You can see a pile of ashes, a knife, a stick, a jacket, a piece of wood and a palm tree here.

What next? :

>drop firewood
Dropped.

What next? :

>light firewood with matches
You take the branches that you collected and create a neat little pyramid of wood.  It takes three matches before it catches, but then a little cheerful fire begins to blossom, and the wood starts crackling.

What next? :

>l
White Sand Beach
.... You are on a beautiful island beach. To the east there is nothing but ocean for as far as the eye can see. This white sand beach extends north and south.  To the west is a lush jungle of green vegetation.

You can see a bright fire, a knife, a stick, a jacket, a piece of wood and a palm tree here.

What next? :

>l
White Sand Beach
.... You are on a beautiful island beach. To the east there is nothing but ocean for as far as the eye can see. This white sand beach extends north and south.  To the west is a lush jungle of green vegetation.

You can see a bright fire, a knife, a stick, a jacket, a piece of wood and a palm tree here.

What next? :

>look at fire
The fire is crackling cheerfully.

What next? :

>look at fire
The fire is crackling cheerfully.

What next? :

>look at fire
The fire is burning low.

What next? :

>look at fire
The fire is burning low.

The fire is burning low and is about to go out.

What next? :

>cook fish
The fire isn't hot enough.

What next? :

>eat fish
You remember your doctor telling you about your weak immune system, and warning you never to eat sushi.

What next? :

>l
White Sand Beach
.... You are on a beautiful island beach. To the east there is nothing but ocean for as far as the eye can see. This white sand beach extends north and south.  To the west is a lush jungle of green vegetation.

You can see a dwindling fire, a knife, a stick, a jacket, a piece of wood and a palm tree here.

The fire has gone out.

What next? :

>w
Animal Trail
.... Under the thick canopy of trees large leafed plants gather what sunlight they can. Dead branches litter the ground. Some kind of animals have beaten down a narrow path between the vegetation.  The path leads west into the jungle and east to the White Sand Beach.

You can see Branches here.

What next? :

* * *

>e
White Sand Beach
.... You are on a beautiful island beach. To the east there is nothing but ocean for as far as the eye can see. This white sand beach extends north and south.  To the west is a lush jungle of green vegetation.

You can see a pile of ashes, a knife, a stick, a jacket, a piece of wood and a palm tree here.

What next? :

>light firewood with matches
You take the branches that you collected and create a neat little pyramid of wood.  It takes three matches before it catches, but then a little cheerful fire begins to blossom, and the wood starts crackling.

What next? :

* * *

>cook fish
You lay the fish over the fire and flip it every few minutes until it is golden brown. The fragrant smells of cooked meat make you suddenly ravenous.

What next? :

>eat fish
You consume the delicous meat of the cooked fish.  Your stomach is feeling full and content.

What next? :

* * *

>w
Trickling Stream
A little stream flows out from the jungle here. The banks are lined with thin saplings and the vegetation is so thick that the only way further to go further west is to wade into the steam.

What next? :

>get sapling
That's hardly portable.

What next? :

>e
Lagoon
.... There is a small pool of water about twenty feet in diameter here. It appears to be fed by a stream flowing out of the jungle in the west. The water is so crystal clear that you can easily see the bottom. In the pool, several fish of varying sizes and spectacular colors swim leisurely about in the warm water.

You can see a pool (in which are a yellow fish, a speckled fish and a striped fish) here.

What next? :

>i
You are carrying:
  a knife

What next? :

>cut sapling with knife
You can't see any such thing.

What next? :

>i
You are carrying:
  a knife

What next? :

>e
South Beach
.... You are on the beach a little south from where you came ashore.  You can see your sailboard to the north. The surf washes over the sand with a sigh and hiss. The jungle is to the west and there is a little pool of water to the west from which a narrow stream of water flows out into the ocean.

What next? :

>w
Lagoon
.... There is a small pool of water about twenty feet in diameter here. It appears to be fed by a stream flowing out of the jungle in the west. The water is so crystal clear that you can easily see the bottom. In the pool, several fish of varying sizes and spectacular colors swim leisurely about in the warm water.

You can see a pool (in which are a yellow fish, a speckled fish and a striped fish) here.

What next? :

* * *

>stab fish
Who do you mean, the yellow fish, the speckled fish or the striped fish?

What next? :

>stab the yellow fish
You must supply a second noun.

What next? :

* * *

>stab the yellow fish with the spear
Good aim!  You expertly spear the fish through its middle.

What next? :

>e
South Beach
.... You are on the beach a little south from where you came ashore.  You can see your sailboard to the north. The surf washes over the sand with a sigh and hiss. The jungle is to the west and there is a little pool of water to the west from which a narrow stream of water flows out into the ocean.

What next? :

* * *

>e
White Sand Beach
.... You are on a beautiful island beach. To the east there is nothing but ocean for as far as the eye can see. This white sand beach extends north and south.  To the west is a lush jungle of green vegetation.

You can see a stick, a jacket, a piece of wood and a palm tree here.

What next? :

>i
You are carrying:
  firewood
  a spear
    a yellow fish
  a knife

What next? :

>drop spear
Dropped.

What next? :

>l
White Sand Beach
.... You are on a beautiful island beach. To the east there is nothing but ocean for as far as the eye can see. This white sand beach extends north and south.  To the west is a lush jungle of green vegetation.

You can see a spear (on which is a yellow fish), a stick, a jacket, a piece of wood and a palm tree here.

What next? :

>get matches
You're carrying too many things already.

What next? :

>i
You are carrying:
  firewood
  a knife

What next? :

>drop firewood
Dropped.

What next? :

>get matches
Taken.

What next? :

>start the firewood with the matches
I didn't understand that sentence.

What next? :

>light the firewood with the matches
You take the branches that you collected and create a neat little pyramid of wood.  It takes three matches before it catches, but then a little cheerful fire begins to blossom, and the wood starts crackling.

What next? :

>cook the fish
You lay the fish over the fire and flip it every few minutes until it is golden brown. The fragrant smells of cooked meat make you suddenly ravenous.

What next? :

>cook the sky
You can't see any such thing.

What next? :

>cook the yellow fish
You lay the fish over the fire and flip it every few minutes until it is golden brown. The fragrant smells of cooked meat make you suddenly ravenous.

What next? :

>i
You are carrying:
  a book of matches
  a knife

What next? :

>get fish
You pluck the yellow fish from the end of your spear.

What next? :

>i
You are carrying:
  a yellow fish
  a book of matches
  a knife

What next? :

>look at yellow fish
This fish is silver on the bottom and has a light green back with a yellow stripe along its sides.

The fire is burning low and is about to go out.

What next? :

* * *

>w
Lagoon
.... There is a small pool of water about twenty feet in diameter here. It appears to be fed by a stream flowing out of the jungle in the west. The water is so crystal clear that you can easily see the bottom. In the pool, several fish of varying sizes and spectacular colors swim leisurely about in the warm water.

You can see a pool (in which are a yellow fish, a speckled fish and a striped fish) here.

What next? :

>e
South Beach
.... You are on the beach a little south from where you came ashore.  You can see your sailboard to the north. The surf washes over the sand with a sigh and hiss. The jungle is to the west and there is a little pool of water to the west from which a narrow stream of water flows out into the ocean.

What next? :

* * *

>n
White Sand Beach
.... You are on a beautiful island beach. To the east there is nothing but ocean for as far as the eye can see. This white sand beach extends north and south.  To the west is a lush jungle of green vegetation.

....  You continue to swim and are getting tired.  There is a stick of very wet driftwood here, about six feet long and and three inches thick.

You can also see a jacket, a piece of wood and a palm tree here.

What next? :

>get knife
Taken.

What next? :

* * *

>stab yellow fish with the spear
Good aim!  You expertly spear the fish through its middle.

What next? :

>w
Trickling Stream
A little stream flows out from the jungle here. The banks are lined with thin saplings and the vegetation is so thick that the only way further to go further west is to wade into the steam.

You can see Saplings here.

What next? :

>e
Lagoon
.... There is a small pool of water about twenty feet in diameter here. It appears to be fed by a stream flowing out of the jungle in the west. The water is so crystal clear that you can easily see the bottom. In the pool, several fish of varying sizes and spectacular colors swim leisurely about in the warm water.

You can see a pool (in which are a speckled fish and a striped fish) here.

What next? :

>e
South Beach
.... You are on the beach a little south from where you came ashore.  You can see your sailboard to the north. The surf washes over the sand with a sigh and hiss. The jungle is to the west and there is a little pool of water to the west from which a narrow stream of water flows out into the ocean.

What next? :

* * *

>e
White Sand Beach
.... You are on a beautiful island beach. To the east there is nothing but ocean for as far as the eye can see. This white sand beach extends north and south.  To the west is a lush jungle of green vegetation.

....  You continue to swim and are getting tired.  There is a stick of very wet driftwood here, about six feet long and and three inches thick.

You can also see a jacket, a piece of wood and a palm tree here.

What next? :

>wear the jacket
(first taking the jacket)
You're carrying too many things already.

What next? :

>start fire
You must supply a noun.

What next? :

>start fire with matches
I didn't understand that sentence.

What next? :

>light the firewood with the matches
You need someting to light the fire with.

What next? :

* * *

>drop spear
Dropped.

What next? :

>get matches
You're carrying too many things already.

What next? :

>drop knife
Dropped.

What next? :

>get matches
Taken.

What next? :

* * *

You take the branches that you collected and create a neat little pyramid of wood.  It takes three matches before it catches, but then a little cheerful fire begins to blossom, and the wood starts crackling.

What next? :

* * *

>w
Lagoon
.... There is a small pool of water about twenty feet in diameter here. It appears to be fed by a stream flowing out of the jungle in the west. The water is so crystal clear that you can easily see the bottom. In the pool, several fish of varying sizes and spectacular colors swim leisurely about in the warm water.

You can see a pool (in which are a yellow fish, a speckled fish and a striped fish) here.

What next? :

>stab yellow fish
(with the pool)
What next?

>i
You are carrying nothing.

What next?

* * *

>w
Lagoon
.... There is a small pool of water about twenty feet in diameter here. It appears to be fed by a stream flowing out of the jungle in the west. The water is so crystal clear that you can easily see the bottom. In the pool, several fish of varying sizes and spectacular colors swim leisurely about in the warm water.

You can see a pool (in which are a yellow fish, a speckled fish and a striped fish) here.

What next? :

>w
Trickling Stream
A little stream flows out from the jungle here. The banks are lined with thin saplings and the vegetation is so thick that the only way further to go further west is to wade into the steam.

You can see Saplings here.

What next?

>cut sapling
You don't have anything to cut with.

What next?

>e
Lagoon
.... There is a small pool of water about twenty feet in diameter here. It appears to be fed by a stream flowing out of the jungle in the west. The water is so crystal clear that you can easily see the bottom. In the pool, several fish of varying sizes and spectacular colors swim leisurely about in the warm water.

You can see a pool (in which are a yellow fish, a speckled fish and a striped fish) here.

What next?

>e
South Beach
.... You are on the beach a little south from where you came ashore.  You can see your sailboard to the north. The surf washes over the sand with a sigh and hiss. The jungle is to the west and there is a little pool of water to the west from which a narrow stream of water flows out into the ocean.

What next?

* * *

>n
White Sand Beach
.... You are on a beautiful island beach. To the east there is nothing but ocean for as far as the eye can see. This white sand beach extends north and south.  To the west is a lush jungle of green vegetation.

....  You continue to swim and are getting tired.  There is a stick of very wet driftwood here, about six feet long and and three inches thick.

You can also see a jacket, a piece of wood and a palm tree here.

What next?

>get knife
Taken.

What next?

>s
South Beach
.... You are on the beach a little south from where you came ashore.  You can see your sailboard to the north. The surf washes over the sand with a sigh and hiss. The jungle is to the west and there is a little pool of water to the west from which a narrow stream of water flows out into the ocean.

What next?

* * *

>w
Lagoon
.... There is a small pool of water about twenty feet in diameter here. It appears to be fed by a stream flowing out of the jungle in the west. The water is so crystal clear that you can easily see the bottom. In the pool, several fish of varying sizes and spectacular colors swim leisurely about in the warm water.

You can see a pool (in which are a yellow fish, a speckled fish and a striped fish) here.

What next?

>w
Trickling Stream
A little stream flows out from the jungle here. The banks are lined with thin saplings and the vegetation is so thick that the only way further to go further west is to wade into the steam.

You can see Saplings here.

What next?

>cut sapling
What do you want to cut the Saplings with?

What next?

>cut sapling with knife
You cut one of the saplings down with your knife. The wood is green and the knife is thin. Your knife constantly gets stuck, but you eventually manage to cut through.  You sharpen one end of the cut sapling, and now have a functional spear.

What next?

>i
You are carrying:
  a spear
  a knife

What next?

>undo
Trickling Stream
[Previous turn undone.]

What next?

>l
Trickling Stream
A little stream flows out from the jungle here. The banks are lined with thin saplings and the vegetation is so thick that the only way further to go further west is to wade into the steam.

You can see Saplings here.

What next?

>i
You are carrying:
  a spear
  a knife

What next?

* * *

>undo
Trickling Stream
[Previous turn undone.]

What next?

>undo
Trickling Stream
[Previous turn undone.]

What next?

>i
You are carrying:
  a knife

What next?

>l
Trickling Stream
A little stream flows out from the jungle here. The banks are lined with thin saplings and the vegetation is so thick that the only way further to go further west is to wade into the steam.

You can see Saplings here.

What next?

>cut sapling
What do you want to cut the Saplings with?

What next?

I beg your pardon?

What next?

>i
You are carrying:
  a knife

What next?

I beg your pardon?

What next?

>\\
That's not a verb I recognise.

What next?

* * *

I beg your pardon?

What next?

>e
Lagoon
.... There is a small pool of water about twenty feet in diameter here. It appears to be fed by a stream flowing out of the jungle in the west. The water is so crystal clear that you can easily see the bottom. In the pool, several fish of varying sizes and spectacular colors swim leisurely about in the warm water.

You can see a pool (in which are a yellow fish, a speckled fish and a striped fish) here.

What next?

>i
You are carrying:
  a knife

What next?

>stab the yellow fish
(with the knife)
What next?

>i
You are carrying:
  a knife

What next?

>l
Lagoon
.... There is a small pool of water about twenty feet in diameter here. It appears to be fed by a stream flowing out of the jungle in the west. The water is so crystal clear that you can easily see the bottom. In the pool, several fish of varying sizes and spectacular colors swim leisurely about in the warm water.

You can see a pool (in which are a yellow fish, a speckled fish and a striped fish) here.

What next?

* * *

>e
Lagoon
.... There is a small pool of water about twenty feet in diameter here. It appears to be fed by a stream flowing out of the jungle in the west. The water is so crystal clear that you can easily see the bottom. In the pool, several fish of varying sizes and spectacular colors swim leisurely about in the warm water.

You can see a pool (in which are a yellow fish, a speckled fish and a striped fish) here.

What next?

>get yellow fish
The fish avoids you and darts away into the deeper parts of the crystal clear pool.

What next?

>l
Lagoon
.... There is a small pool of water about twenty feet in diameter here. It appears to be fed by a stream flowing out of the jungle in the west. The water is so crystal clear that you can easily see the bottom. In the pool, several fish of varying sizes and spectacular colors swim leisurely about in the warm water.

You can see a pool (in which are a yellow fish, a speckled fish and a striped fish) here.

What next?

>i
You are carrying:
  a spear

What next?

>spear fish
That's not a verb I recognise.

What next?

>stab the fis
You can't see any such thing.

What next?

>stab the fish
Who do you mean, the yellow fish, the speckled fish or the striped fish?

What next?

>stab the yellow fish
(with the spear)
Good aim!  You expertly spear the fish through its middle.

What next?

>i
You are carrying:
  a spear
    a yellow fish

What next?

>l
Lagoon
.... There is a small pool of water about twenty feet in diameter here. It appears to be fed by a stream flowing out of the jungle in the west. The water is so crystal clear that you can easily see the bottom. In the pool, several fish of varying sizes and spectacular colors swim leisurely about in the warm water.

You can see a pool (in which are a speckled fish and a striped fish) here.

What next?

>stab the striped fish
(with the spear)
You can't use your spear. There's already fish on it!

What next?

>i
You are carrying:
  a spear
    a yellow fish

What next?

>stab the striped fish
(with the spear)
You can't use your spear. There's already fish on it!

What next?

>look at the spear
This is the spear that you fashioned from a green sapling.

On the spear is a yellow fish.

What next?

>get the yellow fish
You pluck the yellow fish from the end of your spear.

What next?

>i
You are carrying:
  a yellow fish
  a spear

What next?

>stab the speckled fish
What do you want to stab the speckled fish with?

What next?

>stab the speckled fish with the spear
Good aim!  You expertly spear the fish through its middle.

What next?

>l
Lagoon
.... There is a small pool of water about twenty feet in diameter here. It appears to be fed by a stream flowing out of the jungle in the west. The water is so crystal clear that you can easily see the bottom. In the pool, several fish of varying sizes and spectacular colors swim leisurely about in the warm water.

You can see a pool (in which is a striped fish) here.

What next?

>stab the striped fish with the spear
You can't use your spear. There's already fish on it!

What next?

>get the striped fish
You pluck the striped fish from the end of your spear.

What next?

>stab the striped fish with the spear
You can't use your spear. There's already fish on it!

What next?

>i
You are carrying:
  a striped fish
  a yellow fish
  a spear
    a speckled fish

What next?

* * *

>e
Lagoon
.... There is a small pool of water about twenty feet in diameter here. It appears to be fed by a stream flowing out of the jungle in the west. The water is so crystal clear that you can easily see the bottom. In the pool, several fish of varying sizes and spectacular colors swim leisurely about in the warm water.

You can see a pool (in which are a yellow fish, a speckled fish and a striped fish) here.

What next?

>stab fish
Who do you mean, the yellow fish, the speckled fish or the striped fish?

What next?

>stab the yellow fish
(with the pool)
What next?

>i
You are carrying nothing.

What next?

>stab the speckled fish
(with the spear)
You can't use your spear. There's already fish on it!

What next?

>i
You are carrying:
  a spear
    a yellow fish

What next?

>get the yellow fish
You pluck the yellow fish from the end of your spear.

What next?

* * *

>stab the speckled fish with the spear
Good aim!  You expertly spear the fish through its middle.

What next?

>i
You are carrying:
  a yellow fish
  a spear
    a speckled fish

What next?

>stab the striped fish
What do you want to stab the striped fish with?

What next?

>stab the striped fish the spear
I didn't understand that sentence.

What next?

>the spear
That's not a verb I recognise.

What next?

>stab the striped fish with the spear
You can't use your spear. There's already fish on it!

What next?

>i
You are carrying:
  a yellow fish
  a spear
    a speckled fish

What next?

>get speckled fish
You pluck the speckled fish from the end of your spear.

What next?

>i
You are carrying:
  a speckled fish
  a yellow fish
  a spear

What next?

>stab the striped fish with the spear
Good aim!  You expertly spear the fish through its middle.

What next?

>i
You are carrying:
  a speckled fish
  a yellow fish
  a spear
    a striped fish

What next?

>get striped fish
You pluck the striped fish from the end of your spear.

What next?

>i
You are carrying:
  a striped fish
  a speckled fish
  a yellow fish
  a spear

What next?

>n
You can't go that way.

What next?

* * *

>n
White Sand Beach
.... You are on a beautiful island beach. To the east there is nothing but ocean for as far as the eye can see. This white sand beach extends north and south.  To the west is a lush jungle of green vegetation.

....  You continue to swim and are getting tired.  There is a stick of very wet driftwood here, about six feet long and and three inches thick.

You can also see a jacket, a piece of wood and a palm tree here.

What next?

>climb the palm tree
Little is to be achieved by that.

What next?

>s
South Beach
.... You are on the beach a little south from where you came ashore.  You can see your sailboard to the north. The surf washes over the sand with a sigh and hiss. The jungle is to the west and there is a little pool of water to the west from which a narrow stream of water flows out into the ocean.

What next?

>w
Lagoon
.... There is a small pool of water about twenty feet in diameter here. It appears to be fed by a stream flowing out of the jungle in the west. The water is so crystal clear that you can easily see the bottom. In the pool, several fish of varying sizes and spectacular colors swim leisurely about in the warm water.

You can see a pool (empty) here.

What next?

>w
Trickling Stream
A little stream flows out from the jungle here. The banks are lined with thin saplings and the vegetation is so thick that the only way further to go further west is to wade into the steam.

You can see Saplings here.

What next?

>cut the sapling
You cut one of the saplings down with your knife. The wood is green and the knife is thin. Your knife constantly gets stuck, but you eventually manage to cut through.  You sharpen one end of the cut sapling.  You now have a functional spear.

What next?

>i
You are carrying:
  a spear
  a striped fish
  a speckled fish
  a yellow fish

What next?

>cut
What do you want to cut?

What next?

>cut saplings
You cut one of the saplings down with your knife. The wood is green and the knife is thin. Your knife constantly gets stuck, but you eventually manage to cut through.  You sharpen one end of the cut sapling.  You now have a functional spear.

What next?

* * *

>e
Lagoon
.... There is a small pool of water about twenty feet in diameter here. It appears to be fed by a stream flowing out of the jungle in the west. The water is so crystal clear that you can easily see the bottom. In the pool, several fish of varying sizes and spectacular colors swim leisurely about in the warm water.

You can see a pool (in which are a yellow fish, a speckled fish and a striped fish) here.

What next?

>stab yellow fish
(with the spear)
Good aim!  You expertly spear the fish it's middle.

What next?

>get yellow fish
The fish avoids you and darts away into the deeper parts of the crystal clear pool.

What next?

>i
You are carrying:
  a spear
    a yellow fish

What next?

I beg your pardon?

What next?

>get get speckled fish
You can't see any such thing.

What next?

>get speckled fish
The fish avoids you and darts away into the deeper parts of the crystal clear pool.

What next?

>i
You are carrying:
  a spear
    a yellow fish

What next?

* * *

>l
Lagoon
.... There is a small pool of water about twenty feet in diameter here. It appears to be fed by a stream flowing out of the jungle in the west. The water is so crystal clear that you can easily see the bottom. In the pool, several fish of varying sizes and spectacular colors swim leisurely about in the warm water.

You can see a pool (in which are a speckled fish and a striped fish) here.

What next?

>get yellow fish
The fish avoids you and darts away into the deeper parts of the crystal clear pool.

What next?

* * *

>i
You are carrying:
  a spear
    a yellow fish

What next?

>stab fish
Who do you mean, the speckled fish, the striped fish or the yellow fish?

What next?

>stab the yellow fish
(with the spear)
Good aim!  You expertly spear the fish it's middle.

What next?

>i
You are carrying:
  a spear
    a yellow fish

What next?

>get the speckled fish
The fish avoids you and darts away into the deeper parts of the crystal clear pool.

What next?

>stab the speckled fish
(with the spear)
Good aim!  You expertly spear the fish it's middle.

What next?

>i
You are carrying:
  a spear
    a speckled fish
    a yellow fish

What next?

>l
Lagoon
.... There is a small pool of water about twenty feet in diameter here. It appears to be fed by a stream flowing out of the jungle in the west. The water is so crystal clear that you can easily see the bottom. In the pool, several fish of varying sizes and spectacular colors swim leisurely about in the warm water.

You can see a pool (in which is a striped fish) here.

What next?

>stab the striped fish with the yellow fish
What next?

>i
You are carrying:
  a spear
    a speckled fish
    a yellow fish

What next?

* * *

>l
Lagoon
.... There is a small pool of water about twenty feet in diameter here. It appears to be fed by a stream flowing out of the jungle in the west. The water is so crystal clear that you can easily see the bottom. In the pool, several fish of varying sizes and spectacular colors swim leisurely about in the warm water.

You can see a pool (in which is a striped fish) here.

What next?

>get striped fish
The fish avoids you and darts away into the deeper parts of the crystal clear pool.

What next?

>i
You are carrying:
  a spear
    a speckled fish
    a yellow fish

What next?

* * *

>cut sapling
You don't have anything to cut with.

What next?

>i
You are carrying: 
a spear
(Health: 100)

What next?

>s
You can't go that way.

What next?

>e
Lagoon
.... There is a small pool of water about twenty feet in diameter here. It appears to be fed by a stream flowing out of the jungle in the west. The water is so crystal clear that you can easily see the bottom. In the pool, several fish of varying sizes and spectacular colors swim leisurely about in the warm water.

You can see a pool (in which are a yellow fish, a speckled fish and a striped fish) here.

What next?

>kill fish
Who do you mean, the yellow fish, the speckled fish or the striped fish?

What next?

>kill yellow fish
Violence isn't the answer to this one.

What next?

>stab yellow fish
(with the spear)
You need a bladed weapon to stab anything.

What next?

* * *

>w
Trickling Stream
A little stream flows out from the jungle here. The banks are lined with thin saplings and the vegetation is so thick that the only way further to go further west is to wade into the steam.

You can see Saplings here.

What next?

>cut saplings
You don't have anything to cut with.

What next?

>cut saplings with the knife
You can't see any such thing.

What next?

>s
You can't go that way.

What next?

* * *

>s
South Beach
.... You are on the beach a little south from where you came ashore.  You can see your sailboard to the north. The surf washes over the sand with a sigh and hiss. The jungle is to the west and there is a little pool of water to the west from which a narrow stream of water flows out into the ocean.

What next?

>s
You can't go that way.

What next?

>w
Lagoon
.... There is a small pool of water about twenty feet in diameter here. It appears to be fed by a stream flowing out of the jungle in the west. The water is so crystal clear that you can easily see the bottom. In the pool, several fish of varying sizes and spectacular colors swim leisurely about in the warm water.

You can see a pool (in which are a yellow fish, a speckled fish and a striped fish) here.

What next?

* * *

>w
Trickling Stream
A little stream flows out from the jungle here. The banks are lined with thin saplings and the vegetation is so thick that the only way further to go further west is to wade into the steam.

You can see Saplings here.

What next?

>cut sapling with knife
You cut one of the saplings down with your knife. The wood is green and the knife is thin. Your knife constantly gets stuck, but you eventually manage to cut through.  You sharpen one end of the cut sapling.  You now have a functional spear.

What next?

>cut sapling
Cutting it up would achieve little.

What next?

>stab sapling
What do you want to stab Saplings with?

What next?

* * *

>cut saplings
You don't have anything to cut with.

What next?

>i
You are carrying nothing.

What next?

>s
You can't go that way.

What next?

* * *

>w
Trickling Stream
A little stream flows out from the jungle here. The banks are lined with thin saplings and the vegetation is so thick that the only way further to go further west is to wade into the steam.

You can see Saplings here.

What next?

>cut saplings with knfie
You can't see any such thing.

What next?

>cut saplings with knife
You cut one of the saplings down with your knife. The wood is green and the knife is thin. Your knife constantly gets stuck, but you eventually manage to cut through.  You sharpen one end of the cut sapling, and now have a functional spear.

What next?

>i
You are carrying:
  a spear
  a knife

What next?

>s
You can't go that way.

What next?

>w
You can't go that way.

What next?

>e
Lagoon
.... There is a small pool of water about twenty feet in diameter here. It appears to be fed by a stream flowing out of the jungle in the west. The water is so crystal clear that you can easily see the bottom. In the pool, several fish of varying sizes and spectacular colors swim leisurely about in the warm water.

You can see a pool (in which are a yellow fish, a speckled fish and a striped fish) here.

What next?

>w
Trickling Stream
A little stream flows out from the jungle here. The banks are lined with thin saplings and the vegetation is so thick that the only way further to go further west is to wade into the steam.

You can see Saplings here.

What next?

>drop spear
Dropped.

What next?

>drop knife
Dropped.

What next?

>w
You can't go that way.

What next?

* * *

>stab fish
Who do you mean, the yellow fish, the speckled fish or the striped fish?

What next?

>stab yellow fish
(with the pool)
You can't stab the yellow fish with that!

What next?

>e
South Beach
.... You are on the beach a little south from where you came ashore.  You can see your sailboard to the north. The surf washes over the sand with a sigh and hiss. The jungle is to the west and there is a little pool of water to the west from which a narrow stream of water flows out into the ocean.

What next?

>w
Lagoon
.... There is a small pool of water about twenty feet in diameter here. It appears to be fed by a stream flowing out of the jungle in the west. The water is so crystal clear that you can easily see the bottom. In the pool, several fish of varying sizes and spectacular colors swim leisurely about in the warm water.

You can see a pool (in which are a yellow fish, a speckled fish and a striped fish) here.

What next?

>w
Trickling Stream
A little stream flows out from the jungle here. The banks are lined with thin saplings and the vegetation is so thick that the only way further to go further west is to wade into the steam.

You can see a knife, a spear and Saplings here.

What next?

>get knife
Taken.

What next?

>e
Lagoon
.... There is a small pool of water about twenty feet in diameter here. It appears to be fed by a stream flowing out of the jungle in the west. The water is so crystal clear that you can easily see the bottom. In the pool, several fish of varying sizes and spectacular colors swim leisurely about in the warm water.

You can see a pool (in which are a yellow fish, a speckled fish and a striped fish) here.

What next?

>stab yellow fish
(with the knife)
You can't stab the yellow fish with that!

What next?

>w
Trickling Stream
A little stream flows out from the jungle here. The banks are lined with thin saplings and the vegetation is so thick that the only way further to go further west is to wade into the steam.

You can see a spear and Saplings here.

What next?

>get spear
Taken.

What next?

>i
You are carrying:
  a spear
  a knife

What next?

>l
Trickling Stream
A little stream flows out from the jungle here. The banks are lined with thin saplings and the vegetation is so thick that the only way further to go further west is to wade into the steam.

You can see Saplings here.

What next?

>get knife
You already have that.

What next?

>cut sapling wth knife
I only understood you as far as wanting to cut Saplings.

What next?

>i
You are carrying:
  a spear
  a knife

What next?

* * *

>l
Trickling Stream
A little stream flows out from the jungle here. The banks are lined with thin saplings and the vegetation is so thick that the only way further to go further west is to wade into the steam.

You can see Saplings here.

What next?

>get the spear
You already have that.

What next?

>i
You are carrying:
  a spear
  a knife

What next?

>w
You can't go that way.

What next?

* * *

>e
Lagoon
.... There is a small pool of water about twenty feet in diameter here. It appears to be fed by a stream flowing out of the jungle in the west. The water is so crystal clear that you can easily see the bottom. In the pool, several fish of varying sizes and spectacular colors swim leisurely about in the warm water.

You can see a pool (in which are a yellow fish, a speckled fish and a striped fish) here.

What next?

>stab yellow fish
What do you want to stab the yellow fish with?

What next?

>stab the yellow fish with the spear
Good aim!  You expertly spear the fish through its middle.

What next?

>i
You are carrying:
  a spear
    a yellow fish
  a knife

What next?

>stab the striped fish
What do you want to stab the striped fish with?

What next?

>stab the striped fish with the spear
You can't use your spear. There's already fish on it!

What next?

>take the yellow fish off of the spear
You can't see any such thing.

What next?

>take the yellow fish
You pluck the yellow fish from the end of your spear.

What next?

>stab the striped fish with the spear
Good aim!  You expertly spear the fish through its middle.

What next?

>take the striped fish from the spear
You pluck the striped fish from the end of your spear.

What next?

>i
You are carrying:
  a striped fish
  a yellow fish
  a spear
  a knife

What next?

I beg your pardon?

What next?

>l
Lagoon
.... There is a small pool of water about twenty feet in diameter here. It appears to be fed by a stream flowing out of the jungle in the west. The water is so crystal clear that you can easily see the bottom. In the pool, several fish of varying sizes and spectacular colors swim leisurely about in the warm water.

You can see a pool (in which is a speckled fish) here.

What next?

>get the speckled fish
The fish avoids you and darts away into the deeper parts of the crystal clear pool.

What next?

>stab the speckled fish
What do you want to stab the speckled fish with?

What next?

>stab the speckled fish the spear
I didn't understand that sentence.

What next?

>stab the speckled fish with the spear
Good aim!  You expertly spear the fish through its middle.

What next?

>i
You are carrying:
  a striped fish
  a yellow fish
  a spear
    a speckled fish
  a knife

What next?

>e
South Beach
.... You are on the beach a little south from where you came ashore.  You can see your sailboard to the north. The surf washes over the sand with a sigh and hiss. The jungle is to the west and there is a little pool of water to the west from which a narrow stream of water flows out into the ocean.

What next?

* * *

>e
Lagoon
.... There is a small pool of water about twenty feet in diameter here. It appears to be fed by a stream flowing out of the jungle in the west. The water is so crystal clear that you can easily see the bottom. In the pool, several fish of varying sizes and spectacular colors swim leisurely about in the warm water.

You can see a pool (in which are a yellow fish, a speckled fish and a striped fish) here.

What next?

>kill yellow fish with knife
I only understood you as far as wanting to kill the yellow fish.

What next?

>kill the yellow fish
Violence isn't the answer to this one.

What next?

>stab the yellow fish
(with the spear)
You stab the yellow fish with your the spear. The yellow fish yells out in pain.  (The yellow fish's health: 87)

What next?

>stab the yellow fish
(with the spear)
You stab the yellow fish with your the spear. The yellow fish yells out in pain.  (The yellow fish's health: 73)

What next?

>stab the yellow fish
(with the spear)
You stab the yellow fish with your the spear. The yellow fish yells out in pain.  (The yellow fish's health: 60)

What next?

>stab the yellow fish
(with the spear)
You stab the yellow fish with your the spear. The yellow fish yells out in pain.  (The yellow fish's health: 46)

What next?

>stab the yellow fish
(with the spear)
You stab the yellow fish with your the spear. The yellow fish yells out in pain.  (The yellow fish's health: 22)

What next?

>stab the yellow fish
(with the spear)
You stab the yellow fish with your the spear. The yellow fish yells out in pain.  (The yellow fish's health: 9)

What next?

>stab the yellow fish
(with the spear)
With one final thrust of your spear, the yellow fish's dead body drops to the ground, dead.

What next?

>l
Lagoon
.... There is a small pool of water about twenty feet in diameter here. It appears to be fed by a stream flowing out of the jungle in the west. The water is so crystal clear that you can easily see the bottom. In the pool, several fish of varying sizes and spectacular colors swim leisurely about in the warm water.

You can see a pool (in which are a yellow fish's dead body, a speckled fish and a striped fish) here.

What next?

>get yellow fish
Must you do that to the yellow fish's dead body? Have a little respect, please.

What next?

* * *

>w
Animal Trail
.... Under the thick canopy of trees large leafed plants gather what sunlight they can. Dead branches litter the ground. Some kind of animals have beaten down a narrow path between the vegetation.  The path leads west into the jungle and east to the White Sand Beach.

You can see Branches here.

What next? :

>get branche
You can't see any such thing.

What next? :

>get branches
You walk around stomping on the branches and breaking them up into smaller pieces.  Soon you have gathered up an armload of useable firewood.

What next? :

* * *

>get matches
Taken.

What next? :

>light the wood
You must supply a second noun.

What next? :

* * *

>e
White Sand Beach
.... You are on a beautiful island beach. To the east there is nothing but ocean for as far as the eye can see. This white sand beach extends north and south.  To the west is a lush jungle of green vegetation.

You can see a stick, a jacket, a piece of wood and a palm tree here.

What next? :

>burn firewood
You will have to specify what to light firewood with.

What next? :

>burn the firewood with the matches
You take the branches that you collected and create a neat little pyramid of wood.  It takes three matches before it catches, but then a little cheerful fire begins to blossom, and the wood starts crackling.

What next? :

>get matches
Taken.

What next? :

>burn the firewood with the matches
You take the branches that you collected and create a neat little pyramid of wood.  It takes three matches before it catches, but then a little cheerful fire begins to blossom, and the wood starts crackling.

What next? :

>burn firewood
You must supply a second noun.

What next? :

>light the firewood
You must supply a second noun.

What next? :

* * *

>burn firewood
You will have to specify what to light firewood with.

What next? :

>get matches
Taken.

What next? :

>light firewood
You take the branches that you collected and create a neat little pyramid of wood.  It takes three matches before it catches, but then a little cheerful fire begins to blossom, and the wood starts crackling.

What next? :

>light the firewood with the matches
You can't see any such thing.

What next? :

>burn the wood
Burning the piece of wood is probably a bad idea.

What next? :

>burn the jacket
Burning the jacket is probably a bad idea.

What next? :

>burn the stick
Burning the stick is probably a bad idea.

What next? :

>l
White Sand Beach
.... You are on a beautiful island beach. To the east there is nothing but ocean for as far as the eye can see. This white sand beach extends north and south.  To the west is a lush jungle of green vegetation.

....  You continue to swim and are getting tired.  There is a stick of very wet driftwood here, about six feet long and and three inches thick.

You can also see a fire, a jacket, a piece of wood and a palm tree here.

What next? :

>look at the fire
You see nothing special about the fire.

What next? :

>s
South Beach
.... You are on the beach a little south from where you came ashore.  You can see your sailboard to the north. The surf washes over the sand with a sigh and hiss. The jungle is to the west and there is a little pool of water to the west from which a narrow stream of water flows out into the ocean.

What next? :

* * *

>w
Trickling Stream
A little stream flows out from the jungle here. The banks are lined with thin saplings and the vegetation is so thick that the only way further to go further west is to wade into the steam.

You can see Saplings here.

What next? :

>e
Lagoon
.... There is a small pool of water about twenty feet in diameter here. It appears to be fed by a stream flowing out of the jungle in the west. The water is so crystal clear that you can easily see the bottom. In the pool, several fish of varying sizes and spectacular colors swim leisurely about in the warm water.

You can see a pool (in which are a yellow fish, a speckled fish and a striped fish) here.

What next? :

>e
South Beach
.... You are on the beach a little south from where you came ashore.  You can see your sailboard to the north. The surf washes over the sand with a sigh and hiss. The jungle is to the west and there is a little pool of water to the west from which a narrow stream of water flows out into the ocean.

What next? :

>n
White Sand Beach
.... You are on a beautiful island beach. To the east there is nothing but ocean for as far as the eye can see. This white sand beach extends north and south.  To the west is a lush jungle of green vegetation.

....  You continue to swim and are getting tired.  There is a stick of very wet driftwood here, about six feet long and and three inches thick.

You can also see a fire, a jacket, a piece of wood and a palm tree here.

What next? :

>get the knife
Taken.

What next? :

>s
South Beach
.... You are on the beach a little south from where you came ashore.  You can see your sailboard to the north. The surf washes over the sand with a sigh and hiss. The jungle is to the west and there is a little pool of water to the west from which a narrow stream of water flows out into the ocean.

What next? :

* * *

>w
Trickling Stream
A little stream flows out from the jungle here. The banks are lined with thin saplings and the vegetation is so thick that the only way further to go further west is to wade into the steam.

You can see Saplings here.

What next? :

>cut saplings
You must supply a second noun.

What next? :

>cut the saplings with the kinfe
I only understood you as far as wanting to cut Saplings.

What next? :

>cut the saplings with the knife
I only understood you as far as wanting to cut Saplings.

What next? :

>cut the saplings
You must supply a second noun.

What next? :

>cut the sapling with the knife
I only understood you as far as wanting to cut Saplings.

What next? :

>cut the sapling
You must supply a second noun.

What next? :

>cut the sapling
You must supply a second noun.

What next? :

>i
You are carrying:
  a knife
  a book of matches

What next? :

* * *

>e
White Sand Beach
.... You are on a beautiful island beach. To the east there is nothing but ocean for as far as the eye can see. This white sand beach extends north and south.  To the west is a lush jungle of green vegetation.

You can see a stick, a jacket, a piece of wood and a palm tree here.

What next? :

>get matches
Taken.

What next? :

>get knife
You're carrying too many things already.

What next? :

>s
South Beach
.... You are on the beach a little south from where you came ashore.  You can see your sailboard to the north. The surf washes over the sand with a sigh and hiss. The jungle is to the west and there is a little pool of water to the west from which a narrow stream of water flows out into the ocean.

What next? :

* * *

>w
Trickling Stream
A little stream flows out from the jungle here. The banks are lined with thin saplings and the vegetation is so thick that the only way further to go further west is to wade into the steam.

You can see Saplings here.

What next? :

>cut sapling
Cutting it up would achieve little.

What next? :

>cut saplings
Cutting it up would achieve little.

What next? :

>cut saplings with knife
You can't see any such thing.

What next? :

>l
Trickling Stream
A little stream flows out from the jungle here. The banks are lined with thin saplings and the vegetation is so thick that the only way further to go further west is to wade into the steam.

You can see Saplings here.

What next? :

>i
You are carrying:
  a book of matches
  firewood

What next? :

>e
Lagoon
.... There is a small pool of water about twenty feet in diameter here. It appears to be fed by a stream flowing out of the jungle in the west. The water is so crystal clear that you can easily see the bottom. In the pool, several fish of varying sizes and spectacular colors swim leisurely about in the warm water.

You can see a pool (in which are a yellow fish, a speckled fish and a striped fish) here.

What next? :

* * *

>n
White Sand Beach
.... You are on a beautiful island beach. To the east there is nothing but ocean for as far as the eye can see. This white sand beach extends north and south.  To the west is a lush jungle of green vegetation.

....  You continue to swim and are getting tired.  There is a stick of very wet driftwood here, about six feet long and and three inches thick.

You can also see a jacket, a piece of wood and a palm tree here.

What next? :

>get knife
You're carrying too many things already.

What next? :

>i
You are carrying:
  a book of matches
  firewood

What next? :

>drop firewood
Dropped.

What next? :

>get knife
Taken.

What next? :

* * *

>cut saplings
Cutting it up would achieve little.

What next? :

>cut saplings with knife
You cut one of the saplings down with your knife. The wood is green and the knife is thin. Your knife constantly gets stuck, but you eventually manage to cut through.  You sharpen one end of the cut sapling, and now have a functional spear.

What next? :

>i
You are carrying:
  a spear
  a knife
  a book of matches

What next? :

>cut the sapling with the knife
You cut one of the saplings down with your knife. The wood is green and the knife is thin. Your knife constantly gets stuck, but you eventually manage to cut through.  You sharpen one end of the cut sapling, and now have a functional spear.

What next? :

>cut sapling
Cutting it up would achieve little.

What next? :

>cut the sapling with the knife
You cut one of the saplings down with your knife. The wood is green and the knife is thin. Your knife constantly gets stuck, but you eventually manage to cut through.  You sharpen one end of the cut sapling, and now have a functional spear.

What next? :

I beg your pardon?

What next? :

>i
You are carrying:
  a spear
  a knife
  a book of matches

What next? :

>w
You can't go that way.

What next? :

* * *

>stab fish
Who do you mean, the yellow fish, the speckled fish or the striped fish?

What next? :

>stab the yellow fish
What do you want to stab the yellow fish with?

What next? :

>stab the yellow fish with the spear
Good aim!  You expertly spear the fish through its middle.

What next? :

* * *

>e
South Beach
.... You are on the beach a little south from where you came ashore.  You can see your sailboard to the north. The surf washes over the sand with a sigh and hiss. The jungle is to the west and there is a little pool of water to the west from which a narrow stream of water flows out into the ocean.

What next? :

>n
White Sand Beach
.... You are on a beautiful island beach. To the east there is nothing but ocean for as far as the eye can see. This white sand beach extends north and south.  To the west is a lush jungle of green vegetation.

....  You continue to swim and are getting tired.  There is a stick of very wet driftwood here, about six feet long and and three inches thick.

You can also see firewood, a jacket, a piece of wood and a palm tree here.

What next? :

>get firewood
You're carrying too many things already.

What next? :

>light firewood with the matches
You take the branches that you collected and create a neat little pyramid of wood.  It takes three matches before it catches, but then a little cheerful fire begins to blossom, and the wood starts crackling.

What next? :

>l
White Sand Beach
.... You are on a beautiful island beach. To the east there is nothing but ocean for as far as the eye can see. This white sand beach extends north and south.  To the west is a lush jungle of green vegetation.

....  You continue to swim and are getting tired.  There is a stick of very wet driftwood here, about six feet long and and three inches thick.

You can also see a fire, a jacket, a piece of wood and a palm tree here.

What next? :

>light firewood
You can't see any such thing.

What next? :

>restart
Are you sure you want to restart?

* * *

>w
Animal Trail
.... Under the thick canopy of trees large leafed plants gather what sunlight they can. Dead branches litter the ground. Some kind of animals have beaten down a narrow path between the vegetation.  The path leads west into the jungle and east to the White Sand Beach.

You can see Branches here.

What next? :

* * *

>get matches
Taken.

What next? :

>light the firewood with the matches
You take the branches that you collected and create a neat little pyramid of wood.  It takes three matches before it catches, but then a little cheerful fire begins to blossom, and the wood starts crackling.

What next? :

>restart
Are you sure you want to restart?

* * *

>light firewood
You take the branches that you collected and create a neat little pyramid of wood.  It takes three matches before it catches, but then a little cheerful fire begins to blossom, and the wood starts crackling.

What next? :

>s
South Beach
.... You are on the beach a little south from where you came ashore.  You can see your sailboard to the north. The surf washes over the sand with a sigh and hiss. The jungle is to the west and there is a little pool of water to the west from which a narrow stream of water flows out into the ocean.

What next? :

* * *

>w
Trickling Stream
A little stream flows out from the jungle here. The banks are lined with thin saplings and the vegetation is so thick that the only way further to go further west is to wade into the steam.

You can see Saplings here.

What next? :

>n
You can't go that way.

What next? :

>e
Lagoon
.... There is a small pool of water about twenty feet in diameter here. It appears to be fed by a stream flowing out of the jungle in the west. The water is so crystal clear that you can easily see the bottom. In the pool, several fish of varying sizes and spectacular colors swim leisurely about in the warm water.

You can see a pool (in which are a yellow fish, a speckled fish and a striped fish) here.

What next? :

* * *

>n
White Sand Beach
.... You are on a beautiful island beach. To the east there is nothing but ocean for as far as the eye can see. This white sand beach extends north and south.  To the west is a lush jungle of green vegetation.

....  You continue to swim and are getting tired.  There is a stick of very wet driftwood here, about six feet long and and three inches thick.

You can also see a fire, a jacket, a piece of wood and a palm tree here.

What next? :

>i
You are carrying:
  a book of matches

What next? :

>get knife
Taken.

What next? :

* * *

>light the firewood with the matches
You take the branches that you collected and create a neat little pyramid of wood.  It takes three matches before it catches, but then a little cheerful fire begins to blossom, and the wood starts crackling.

What next? :

>light the board with the matches
Burning the piece of wood is probably a bad idea.

What next? :

>burn the jacket
This dangerous act would achieve little.

What next? :

>burn the firewood
This dangerous act would achieve little.

What next? :

>burn firewood with the matches
You take the branches that you collected and create a neat little pyramid of wood.  It takes three matches before it catches, but then a little cheerful fire begins to blossom, and the wood starts crackling.

What next? :

>burn the wood with the matches
Burning the piece of wood is probably a bad idea.

What next? :

>burn the firewood
This dangerous act would achieve little.

What next? :

>light the jacket
This dangerous act would achieve little.

What next? :

>light jacket
This dangerous act would achieve little.

What next? :

>light jacket with matches
Burning the jacket is probably a bad idea.

What next? :

>light firewood
This dangerous act would achieve little.

What next? :

>burn firewood
This dangerous act would achieve little.

What next? :

* * *

>get matches
Taken.

What next? :

>light wood
You must supply a second noun.

What next? :

>light the firewood
You must supply a second noun.

What next? :

* * *

>e
White Sand Beach
.... You are on a beautiful island beach. To the east there is nothing but ocean for as far as the eye can see. This white sand beach extends north and south.  To the west is a lush jungle of green vegetation.

You can see a stick, a jacket, a piece of wood and a palm tree here.

What next? :

>light the fire with the matches
You can't see any such thing.

What next? :

>get the matches
Taken.

What next? :

>undo
White Sand Beach
[Previous turn undone.]

What next? :

>light the firewood with the matches
You need someting to light the fire with.

What next? :

>get the matches
Taken.

What next? :

>light the firewood with the matches
You take the branches that you collected and create a neat little pyramid of wood.  It takes three matches before it catches, but then a little cheerful fire begins to blossom, and the wood starts crackling.

What next? :

>look at the fire
The fire is crackling cheerfully.

What next? :

>l
White Sand Beach
.... You are on a beautiful island beach. To the east there is nothing but ocean for as far as the eye can see. This white sand beach extends north and south.  To the west is a lush jungle of green vegetation.

You can see a bright fire, a stick, a jacket, a piece of wood and a palm tree here.

What next? :

>l
White Sand Beach
.... You are on a beautiful island beach. To the east there is nothing but ocean for as far as the eye can see. This white sand beach extends north and south.  To the west is a lush jungle of green vegetation.

You can see a bright fire, a stick, a jacket, a piece of wood and a palm tree here.

What next? :

>l
White Sand Beach
.... You are on a beautiful island beach. To the east there is nothing but ocean for as far as the eye can see. This white sand beach extends north and south.  To the west is a lush jungle of green vegetation.

You can see a dwindling fire, a stick, a jacket, a piece of wood and a palm tree here.

What next? :

>l
White Sand Beach
.... You are on a beautiful island beach. To the east there is nothing but ocean for as far as the eye can see. This white sand beach extends north and south.  To the west is a lush jungle of green vegetation.

You can see a dwindling fire, a stick, a jacket, a piece of wood and a palm tree here.

The fire is burning low and is about to go out.

What next? :

>l
White Sand Beach
.... You are on a beautiful island beach. To the east there is nothing but ocean for as far as the eye can see. This white sand beach extends north and south.  To the west is a lush jungle of green vegetation.

You can see a dwindling fire, a stick, a jacket, a piece of wood and a palm tree here.

What next? :

>l
White Sand Beach
.... You are on a beautiful island beach. To the east there is nothing but ocean for as far as the eye can see. This white sand beach extends north and south.  To the west is a lush jungle of green vegetation.

You can see a dwindling fire, a stick, a jacket, a piece of wood and a palm tree here.

What next? :

>l
White Sand Beach
.... You are on a beautiful island beach. To the east there is nothing but ocean for as far as the eye can see. This white sand beach extends north and south.  To the west is a lush jungle of green vegetation.

You can see a dwindling fire, a stick, a jacket, a piece of wood and a palm tree here.

The fire has gone out.

What next? :

>l
White Sand Beach
.... You are on a beautiful island beach. To the east there is nothing but ocean for as far as the eye can see. This white sand beach extends north and south.  To the west is a lush jungle of green vegetation.

You can see a pile of ashes, a stick, a jacket, a piece of wood and a palm tree here.

What next? :

>look at the fire
The fire is out. Only ashes remain.

What next? :

>cook the yellow fish
You can't see any such thing.

What next? :

>i
You are carrying:
  a book of matches

What next? :

>s
South Beach
.... You are on the beach a little south from where you came ashore.  You can see your sailboard to the north. The surf washes over the sand with a sigh and hiss. The jungle is to the west and there is a little pool of water to the west from which a narrow stream of water flows out into the ocean.

What next? :

* * *

>w
Trickling Stream
A little stream flows out from the jungle here. The banks are lined with thin saplings and the vegetation is so thick that the only way further to go further west is to wade into the steam.

You can see Saplings here.

What next? :

>cut sapling
(with the book of matches)
You can't cut Saplings with that!

What next? :

>w
You can't go that way.

What next? :

* * *

>e
South Beach
.... You are on the beach a little south from where you came ashore.  You can see your sailboard to the north. The surf washes over the sand with a sigh and hiss. The jungle is to the west and there is a little pool of water to the west from which a narrow stream of water flows out into the ocean.

What next? :

>n
White Sand Beach
.... You are on a beautiful island beach. To the east there is nothing but ocean for as far as the eye can see. This white sand beach extends north and south.  To the west is a lush jungle of green vegetation.

You can see a pile of ashes, a stick, a jacket, a piece of wood and a palm tree here.

What next? :

>get knife
Taken.

What next? :

* * *

>w
Trickling Stream
A little stream flows out from the jungle here. The banks are lined with thin saplings and the vegetation is so thick that the only way further to go further west is to wade into the steam.

You can see Saplings here.

What next? :

>cut sapling
What do you want to cut Saplings with?

What next? :

>cut sapling with knife
You cut one of the saplings down with your knife. The wood is green and the knife is thin. Your knife constantly gets stuck, but you eventually manage to cut through.  You sharpen one end of the cut sapling, and now have a functional spear.

What next? :

>i
You are carrying:
  a spear
  a knife
  a book of matches

What next? :

* * *

>e
Lagoon
.... There is a small pool of water about twenty feet in diameter here. It appears to be fed by a stream flowing out of the jungle in the west. The water is so crystal clear that you can easily see the bottom. In the pool, several fish of varying sizes and spectacular colors swim leisurely about in the warm water.

You can see a pool (in which are a yellow fish, a speckled fish and a striped fish) here.

What next? :

>stab the yellow fish
You must supply a second noun.

What next? :

* * *

>n
White Sand Beach
.... You are on a beautiful island beach. To the east there is nothing but ocean for as far as the eye can see. This white sand beach extends north and south.  To the west is a lush jungle of green vegetation.

You can see a pile of ashes, a stick, a jacket, a piece of wood and a palm tree here.

What next? :

>cook the yellow fish
What next? :

* * *

>get branches
You walk around stomping on the branches and breaking them up into smaller pieces.  Soon you have gathered up an armload of useable firewood.

What next? :

>get matches
You can't see any such thing.

What next? :

>get matches from pocket
You can't see any such thing.

What next? :

>e
White Sand Beach
.... You are on a beautiful island beach. To the east there is nothing but ocean for as far as the eye can see. This white sand beach extends north and south.  To the west is a lush jungle of green vegetation.

....  You continue to swim and are getting tired.  There is a stick of very wet driftwood here, about six feet long and and three inches thick.

You can also see a jacket, a piece of wood and a palm tree here.

What next? :

* * *

>get matches
Taken.

What next? :

>light the firewood
You must supply a second noun.

What next? :

* * *

>w
Animal Trail
.... Under the thick canopy of trees large leafed plants gather what sunlight they can. Dead branches litter the ground. Some kind of animals have beaten down a narrow path between the vegetation.  The path leads west into the jungle and east to the White Sand Beach.

You can see Branches here.

What next? :

>get on wood
Thank goodness!  You were getting exhausted just trying to stay a float.

You mount the piece of wood.

What next?

>e
Ocean Waves (on the piece of wood)
....  The water laps at the plank you sit on, rocking you up and down. You can see a dark object bobbing on the surface to the North.

You can see a bug here.

What next?

>get bug
White Sand Beach
.... You are on a beautiful island beach. To the east there is nothing but ocean for as far as the eye can see. This white sand beach extends north and south.  To the west is a lush jungle of green vegetation.

You can see a palm tree here.

What next?

>s
South Beach
.... You are on the beach a little south from where you came ashore.  You can see your sailboard to the north. The surf washes over the sand with a sigh and hiss. The jungle is to the west and there is a little pool of water to the west from which a narrow stream of water flows out into the ocean.

What next?

>w
Lagoon
.... There is a small pool of water about twenty feet in diameter here. It appears to be fed by a stream flowing out of the jungle in the west. The water is so crystal clear that you can easily see the bottom. In the pool, several fish of varying sizes and spectacular colors swim leisurely about in the warm water.

You can see a pool (in which are an Ono, an Akule and a Monchong) here.

What next?

>look in pool
In the pool are an Ono, an Akule and a Monchong.

What next?

>look at Ono
This fish is about a foot long and has silver and black vertical stripes.  It has a long sharp snout.

What next?

>look at Akule
This fish is silver on the bottom and has a light green back with a yellow stripe along its sides.

What next?

>look at Monchong
This fish is narrow and is the shape of a pie plate with fins. It's covered with black and silver scales

What next?

* * *

>get the bug
You can't see any such thing.

What next?  You can say, help, to get more information on how to play.

>get off wood
You dismount the piece of wood.

White Sand Beach
.... You are on a beautiful island beach. To the east there is nothing but ocean for as far as the eye can see. This white sand beach extends north and south.  To the west is a lush jungle of green vegetation.

....  You continue to swim and are getting tired.  There is a stick of very wet driftwood here, about six feet long and and three inches thick.

You can also see a jacket, a piece of wood and a palm tree here.

What next?

* * *

>w
Trickling Stream
A little stream flows out from the jungle here. The banks are lines with thin saplings and the vegetation is so thick that the only way further to go further west is to wade into steam.

You can see Saplings here.

What next?

>cut the saplings
You cut one of the saplings down with your knife. The wood is green and the knife is thin.  Your knife constantly gets stuck, but you eventually manage to cut through one.  A thought comes to you, and you sharpen one end of it.  You now have a functional spear.

What next?

>i
You are carrying: 
a spear
(Health: 100)

What next?

>e
Lagoon
.... There is a small pool of water about twenty feet in diameter here. It appears to be fed by a stream flowing out of the jungle in the west. The water is so crystal clear that you can easily see the bottom. In the pool, several fish of varying sizes and spectacular colors swim leisurely about in the warm water.

You can see a pool (in which are a yellow fish, a speckled fish and a striped fish) here.

What next?

>stab the fish
Who do you mean, the yellow fish, the speckled fish or the striped fish?

What next?

>stab the yellow fish
(with the spear)
You need a bladed weapon to stab anything.

What next?

* * *

>help
You can move your character by using the words, North, East, West or South.  You can check see what you are holding by saying the word, inventory. You can interact with objects by saying, take the object, or interact with them like saying, cut the rope with the knife, or put the stick on the rock.

You think you must have hit your head against the ship during the fall, because a small raised lump on the back of your skull is throbbing.

What next?

>help basics
These are the commands you will use most often. 

"look": Look around the room -- repeat the description of everything you see. 
"examine": Look more closely at something -- learn more about it. 
"inventory": List everything you're carrying. 
"north", "south", "east", "west", etc., etc.: Walk in some direction. 

For more about these commands -- or any command used in this game -- say "help" followed by the command word. For example, "help look".

* * *

>help
You can move your character by using the words, North, East, West or South.  You can check see what you are holding by saying the word, inventory. You can interact with objects by saying, take the object, or interact with them like saying, cut the rope with the knife, or put the stick on the rock.

You think you must have hit your head against the ship during the fall, because a small raised lump on the back of your skull is throbbing.

What next?

>n
   Introduction to Alien Shores
 > Instructions for Play
   Introduction to Alien Shores
 > Instructions for Play

>n
   Introduction to Alien Shores
 > Instructions for Play
   Introduction to Alien Shores
 > Instructions for Play

 > Introduction to Alien Shores
   Instructions for Play
 > Introduction to Alien Shores
   Instructions for Play

This is a simple demonstration Fiction game.

Please press SPACE to continue.

 > Introduction to Alien Shores
   Instructions for Play
 > Introduction to Alien Shores
   Instructions for Play

   Introduction to Alien Shores
 > Instructions for Play
   Introduction to Alien Shores
 > Instructions for Play

 > About Interactive Fiction
   What to do with >
   Getting Started
   Rooms and Travel
   Objects
   Controlling the Game
   How the World is Assembled
   If You Get Stuck

   About Interactive Fiction
 > What to do with >
   Getting Started
   Rooms and Travel
   Objects
   Controlling the Game
   How the World is Assembled
   If You Get Stuck
   About Interactive Fiction
 > What to do with >
   Getting Started
   Rooms and Travel
   Objects
   Controlling the Game
   How the World is Assembled
   If You Get Stuck

The > sign is where the game says, "Okay, what do you want to do now?"  You may respond by typing an instruction -- usually an imperative verb, possibly followed by prepositions and objects.  So, for instance, LOOK, LOOK AT FISH, TAKE FISH.

Please press SPACE to continue.

   About Interactive Fiction
 > What to do with >
   Getting Started
   Rooms and Travel
   Objects
   Controlling the Game
   How the World is Assembled
   If You Get Stuck
   About Interactive Fiction
 > What to do with >
   Getting Started
   Rooms and Travel
   Objects
   Controlling the Game
   How the World is Assembled
   If You Get Stuck

   About Interactive Fiction
   What to do with >
 > Getting Started
   Rooms and Travel
   Objects
   Controlling the Game
   How the World is Assembled
   If You Get Stuck
   About Interactive Fiction
   What to do with >
 > Getting Started
   Rooms and Travel
   Objects
   Controlling the Game
   How the World is Assembled
   If You Get Stuck

The first thing you want to do when starting a game is acquaint yourself with your surroundings and get a sense of your goal. To this end, you should read the introductory text carefully. Sometimes it contains clues. You will also want to look at the room you are in. Notice where the exits from the room are, and what objects are described here. If any of these seem interesting, you may want to EXAMINE them. 

You might also want to examine yourself (EXAMINE ME) to see whether the author has left you any clues about your character. TAKE INVENTORY will tell you what you're carrying, as well.

Once you've gotten your bearings, you may want to explore. Move from room to room, and check out every location available.

Please press SPACE to continue.

   About Interactive Fiction
   What to do with >
 > Getting Started
   Rooms and Travel
   Objects
   Controlling the Game
   How the World is Assembled
   If You Get Stuck
   About Interactive Fiction
   What to do with >
 > Getting Started
   Rooms and Travel
   Objects
   Controlling the Game
   How the World is Assembled
   If You Get Stuck

   Introduction to Alien Shores
 > Instructions for Play

Ocean Waves
 You lay on your back in the warm water as your body floats up and down the rythmic waves. The hot sun beats down on you and there is not a cloud in the clear blue sky.

* * *

>i
You are carrying:
  brochure
    a move page
    a game page
    an object page

You deeply regret trying to stop your phone from falling over the railing of the ship. Now look what's happened.

What next?  You can say, help, to get more information on how to play.

>look at the brochure
This is the brochure that you were given when you boarded the ship. There appears to be a section for what to do in the case of an emergency.

This really sucks. You could be kicking back right now having an ice-cold drink in the ship's lounge.

What next?  You can say, help, to get more information on how to play.

>examine the brochure
This is the brochure that you were given when you boarded the ship. There appears to be a section for what to do in the case of an emergency.

At least one good thing has come of all this, you won't have to worry about ending your vacation any time soon.

What next?  You can say, help, to get more information on how to play.

>open the brochure
It isn't something you can open.

What next?  You can say, help, to get more information on how to play.

* * *

>look at the brochure
This is the brochure that you were given when you boarded the ship. There appears to be a section for what to do in the case of an emergency.

This really sucks. You could be kicking back right now having an ice-cold drink in the ship's lounge.

What next?  You can say, help, to get more information on how to play.

>look in the brochure
Brochure is empty.

At least one good thing has come of all this, you won't have to worry about ending your vacation any time soon.

What next?  You can say, help, to get more information on how to play.

* * *

>k
That's not a verb I recognise.

>l
Ocean Waves
....  You lay on your back in the warm water as your body floats up and down the rythmic waves. The hot sun beats down on you and there is not a cloud in the clear blue sky.

You can see a bug here.

You think you must have hit your head against the ship during the fall, because a small raised lump on the back of your skull is throbbing.

What next?

>l
Ocean Waves
....  You lay on your back in the warm water as your body floats up and down the rythmic waves. The hot sun beats down on you and there is not a cloud in the clear blue sky.

You can see a bug here.

This really sucks. You could be kicking back right now having an ice-cold drink in the ship's lounge.

What next?  You can say, help, to get more information on how to play.

>help
You can move your character by using the words, North, East, West or South.  You can check to see what you are holding by saying the word, inventory. You can interact with objects by saying something like, take the object, or you can interact with things by saying something like, cut the rope with the knife, or, put the stick on the rock.

At least one good thing has come of all this, you won't have to worry about ending your vacation any time soon.

What next?

>restart
Are you sure you want to restart?

>y
.... You are floating in the middle of a tropical ocean.  You hoped that the cruise ship would notice you were missing, but it's been hours, and no ship has appeared on the horizon. You deeply regret trying to stop your phone from falling over the railing of the ship. Now look what's happened.

Alien Shores....
An Interactive Fiction by Keith B Phillips.... Say look, or north, east, west south to move.
Release 1 / Serial number 180911 / Inform 7 build 6M62 (I6/v6.33 lib 6/12N) SD

Ocean Waves
....  You lay on your back in the warm water as your body floats up and down the rythmic waves. The hot sun beats down on you and there is not a cloud in the clear blue sky.

You can see a bug here.

>l
Ocean Waves
....  You lay on your back in the warm water as your body floats up and down the rythmic waves. The hot sun beats down on you and there is not a cloud in the clear blue sky.

You can see a bug here.

You think you must have hit your head against the ship during the fall, because a small raised lump on the back of your skull is throbbing.

What next?

* * *

>l
Ocean Waves
....  You lay on your back in the warm water as your body floats up and down the rythmic waves. The hot sun beats down on you and there is not a cloud in the clear blue sky.

You can see bug here.

You deeply regret trying to stop your phone from falling over the railing of the ship. Now look what's happened.

What next?  You can say, help, to get more information on how to play.

>e
Open Water
 You tread water to stay above water. All that at effort is making you really tired. If only you had something to float on. Nothing but more water can be seen in all directions.

This really sucks. You could be kicking back having an ice-cold drink in the ship's lounge right now.

>e
You can't go that way.

* * *

>w
Piece of Debri
You cling to the piece of wood.  It seems to have been part of a boat at one time.

>e
Open Water
You tread water.  Nothing but more water can be seen.

* * *

>e
You can't go that way.

>n
Small Floating Object
You see an human shape floating face down in the water.

>l
Small Floating Object
You see an human shape floating face down in the water.

>examine body
You can't see any such thing.

* * *

>e
Open Water
 You tread water to stay above water. All that at effort is making you really tired. If only you had something to float on. Nothing but more water can be seen in all directions.

This really sucks. You could be kicking back having an ice-cold drink in the ship's lounge right now.

>l
Open Water
 You tread water to stay above water. All that at effort is making you really tired. If only you had something to float on. Nothing but more water can be seen in all directions.

Well, at least you won't have to worry about ending your vacation any time soon.

>w
Ocean Waves
 You lay on your back in the warm water as the waves lift your body up and down rythmically.

>l
Ocean Waves
 You lay on your back in the warm water as the waves lift your body up and down rythmically. 

You deeply regret trying to stop your phone from falling over the railing of the ship.  Now look what's happened.

* * *

>e
Open Water
 You tread water to stay above water. All that at effort is making you really tired. If only you had something to float on. Nothing but more water can be seen in all directions.

This really sucks. You could be kicking back having an ice-cold drink in the ship's lounge right now.

>w
Ocean Waves
 You lay on your back in the warm water as the waves lift your body up and down rythmically.

>l
Ocean Waves
 You lay on your back in the warm water as the waves lift your body up and down rythmically.

>w
Rippling Waves
 You see a piece of wood about six feet in length. You swim over and cling to it gratefully. You look at the wood, and a chill goes through you. This is actually a board that has been roughly hewn from log.

You can see a piece of wood here.

>get on the wood
You mount the piece of wood.

You're getting so tired of treading water, and the waves are kicking up some in wind. You have to get out of the water soon.

>l
Rippling Waves (on the piece of wood)
 You are sitting on a rough board about six feet in length. All around you is ocean and sky.

* * *

>l
Ocean Waves
....  You lay on your back in the warm water as your body floats up and down the rythmic waves. The hot sun beats down on you and there is not a cloud in the clear blue sky.

You can see bug here.

You deeply regret trying to stop your phone from falling over the railing of the ship. Now look what's happened.

What next?  You can say, help, to get more information on how to play.

>l
Ocean Waves
....  You lay on your back in the warm water as your body floats up and down the rythmic waves. The hot sun beats down on you and there is not a cloud in the clear blue sky.

You can see bug here.

This really sucks. You could be kicking back right now having an ice-cold drink in the ship's lounge.

What next?  You can say, help, to get more information on how to play.

>help
To get more, say "help" followed by whatever it is you want to get help on.. For example, you can say "help basics" to see the most important IF commands.

What next?

>help basics
These are the commands you will use most often. 

"look": Look around the room -- repeat the description of everything you see. 
"examine": Look more closely at something -- learn more about it. 
"inventory": List everything you're carrying. 
"north", "south", "east", "west", etc., etc.: Walk in some direction. 

For more about these commands -- or any command used in this game -- say "help" followed by the command word. For example, "help look".

What next?

>help examine
"examine": Look more closely at something. 

(You can abbreviate this as "x".) 

Inspect an object carefully. You can do this to anything you're carrying, and anything nearby -- most anything you encounter in the game. 

You will often learn more about things if you "examine" them. However, if the game replies "You see nothing special about that," then it's probably not important. If the game replies "You can't see any such thing," then it's definitely not important. 

You can even examine yourself: "x myself" or "x me". This may tell you more about yourself -- information to help you understand the character you are playing. Then again, it may not.

What next?

>l
Ocean Waves
....  You lay on your back in the warm water as your body floats up and down the rythmic waves. The hot sun beats down on you and there is not a cloud in the clear blue sky. 

At least one good thing has come of all this, you won't have to worry about ending your vacation any time soon.

What next?

* * *

>l
Ocean Waves
....  You lay on your back in the warm water as your body floats up and down the rythmic waves. The hot sun beats down on you and there is not a cloud in the clear blue sky.

You can see bug here.

This really sucks. You could be kicking back right now having an ice-cold drink in the ship's lounge.

What next?  You can say, help, to get more information on how to play.

>l
Ocean Waves
....  You lay on your back in the warm water as your body floats up and down the rythmic waves. The hot sun beats down on you and there is not a cloud in the clear blue sky.

You can see bug here.

At least one good thing has come of all this, you won't have to worry about ending your vacation any time soon.

What next?  You can say, help, to get more information on how to play.

>e
Open Water
 You tread water to stay afloat. You're getting tired. If only you had something to float on. Nothing but more water can be seen.

>w
Ocean Waves
 You lay on your back in the warm water as the waves lift your body up and down rythmically.

* * *

>l
Ocean Waves
 You lay on your back in the warm water as the waves lift your body up and down rythmically.

>l
Ocean Waves
 You lay on your back in the warm water as the waves lift your body up and down rythmically. 

You deeply regret trying to stop your phone from falling over the railing of the ship.  Now look what's happened.

>l
Ocean Waves
 You lay on your back in the warm water as the waves lift your body up and down rythmically. 

You deeply regret trying to stop your phone from falling over the railing of the ship.  Now look what's happened.

* * *

>l
Ocean Waves
....  You lay on your back in the warm water as your body floats up and down the rythmic waves. The hot sun beats down on you and there is not a cloud in the clear blue sky.

You can see bug here.

At least one good thing has come of all this, you won't have to worry about ending your vacation any time soon.

What next?  You can say, help, to get more information on how to play.

>help
You can move your character by using the words, North, East, West or South.  You can check to see what you are holding by saying the word, inventory. You can interact with objects by saying something like, take the object, or you can interact with things by saying something like, cut the rope with the knife, or, put the stick on the rock.

What next?

* * *

>l
Ocean Waves
....  You lay on your back in the warm water as your body floats up and down the rythmic waves. The hot sun beats down on you and there is not a cloud in the clear blue sky.

You can see bug here.

At least one good thing has come of all this, you won't have to worry about ending your vacation any time soon.

What next?  You can say, help, to get more information on how to play.

>l
Ocean Waves
....  You lay on your back in the warm water as your body floats up and down the rythmic waves. The hot sun beats down on you and there is not a cloud in the clear blue sky.

You can see a bug here.

What next?  You can say, help, to get more information on how to play.

>e
Open Water
....  You continue to swim. All that effort is making you really tired. If only you had something to float on. Nothing but more ocean can be seen in all directions.

What next?

>help
You can move your character by using the words, North, East, West or South.  You can check to see what you are holding by saying the word, inventory. You can interact with objects by saying something like, take the object, or you can interact with things by saying something like, cut the rope with the knife, or, put the stick on the rock.

What next?

* * *

>l
Ocean Waves
....  You lay on your back in the warm water as your body floats up and down the rythmic waves. The hot sun beats down on you and there is not a cloud in the clear blue sky.

You can see a bug here.

What next?  You can say, help, to get more information on how to play.

>l
Ocean Waves
....  You lay on your back in the warm water as your body floats up and down the rythmic waves. The hot sun beats down on you and there is not a cloud in the clear blue sky.

You can see a bug here.

What next?  You can say, help, to get more information on how to play.

>e
Open Water
....  You continue to swim. All that effort is making you really tired. If only you had something to float on. Nothing but more ocean can be seen in all directions.

What next?  You can say, help, to get more information on how to play.

>n
Even More Open Water
....  You continue to swim and are getting tired.  There is a stick of very wet driftwood here, about six feet long and and three inches thick.

You're getting so tired, and the waves are kicking up some in the wind. You have to get out of the water soon.

What next?  You can say, help, to get more information on how to play.

>w
Glittering Waves
....  You tread water, and you are getting exhausted.  What is left of a human body floats on the surface here.  Something has been eating it.

On the body is a jacket.

What next?

>s
Ocean Waves
....  You lay on your back in the warm water as your body floats up and down the rythmic waves. The hot sun beats down on you and there is not a cloud in the clear blue sky.

You can see a bug here.

You are suddenly exhausted, you try to resume floating on your back again, but the waves are higher now and sweep you under.  You reach for the surface as you sink into the gloom.

    *** You have drowned. ***

Would you like to RESTART, RESTORE a saved game, QUIT or UNDO the last command?

>n
Please give one of the answers above.

Would you like to RESTART, RESTORE a saved game, QUIT or UNDO the last command?

>restart
.... You are floating in the middle of a tropical ocean.  You hoped that the cruise ship would notice you were missing, but it's been hours, and no ship has appeared on the horizon. You deeply regret trying to stop your phone from falling over the railing of the ship. Now look what's happened.

Alien Shores....
An Interactive Fiction by Keith B Phillips....Say look, or north, east, west south to move.
Release 1 / Serial number 180911 / Inform 7 build 6M62 (I6/v6.33 lib 6/12N) SD

Ocean Waves
....  You lay on your back in the warm water as your body floats up and down the rythmic waves. The hot sun beats down on you and there is not a cloud in the clear blue sky.

You can see a bug here.

What next?  You can say, help, to get more information on how to play.

>w
Rippling Waves
....  You see a piece of wood about six feet in length. You swim over and cling to it gratefully. You look at the wood, and a surge of hope goes through you. This is actually a wide board that has been roughly hewn from a log.

You can see a piece of wood here.

You think you must have hit your head against the ship during the fall, because a small raised lump on the back of your skull is throbbing.

What next?  You can say, help, to get more information on how to play.

>n
You begin to paddle in that direction but without a plan or destination you soon lose hope and return.

This really sucks. You could be kicking back right now having an ice-cold drink in the ship's lounge.

What next?

>w
You begin to paddle in that direction but without a plan or destination you soon lose hope and return.

At least one good thing has come of all this, you won't have to worry about ending your vacation any time soon.

What next?

>e
Ocean Waves
....  You lay on your back in the warm water as your body floats up and down the rythmic waves. The hot sun beats down on you and there is not a cloud in the clear blue sky.

You can see a bug here.

What next?

>l
Ocean Waves
....  You lay on your back in the warm water as your body floats up and down the rythmic waves. The hot sun beats down on you and there is not a cloud in the clear blue sky.

You can see a bug here.

What next?

* * *

>l
Ocean Waves
....  You lay on your back in the warm water as your body floats up and down the rythmic waves. The hot sun beats down on you and there is not a cloud in the clear blue sky.

You can see a bug here.

What next?  You can say, help, to get more information on how to play.

>l
Ocean Waves
 You lay on your back in the warm water as the waves lift your body up and down rythmically.

>l
Ocean Waves
 You lay on your back in the warm water as the waves lift your body up and down rythmically. 

You're getting so tired of treading water, and the waves are kicking up some in wind. You have to get out of the water soon.

>l
Ocean Waves
 You lay on your back in the warm water as the waves lift your body up and down rythmically.

>l
Ocean Waves
 You lay on your back in the warm water as the waves lift your body up and down rythmically. 

You are suddenly exhausted, you try to resume floating on your back again, but the waves are higher now and sweep you under.  You reach for the surface as you sink into the gloom.

    *** You have drowned. ***

Would you like to RESTART, RESTORE a saved game, QUIT or UNDO the last command?

>restart
You are floating in the middle of a tropical ocean.  You hoped that the cruise ship would notice you were missing, but it's been hours and hours, and no ship has appeared on the horizon.

Alien Shores
An Interactive Fiction by Keith B Phillips
Release 1 / Serial number 180905 / Inform 7 build 6M62 (I6/v6.33 lib 6/12N) SD

Ocean Waves
 You lay on your back in the warm water as the waves lift your body up and down rythmically.

>l
Ocean Waves
 You lay on your back in the warm water as the waves lift your body up and down rythmically.

* * *

>l
Rippling Waves
 You see a piece of wood about six feet in length. You swim over and cling to it gratefully. You look at the wood, and a chill goes through you. This is actually a board that has been roughly hewn from log.

You can see a piece of wood here.

>l
Rippling Waves
 You see a piece of wood about six feet in length. You swim over and cling to it gratefully. You look at the wood, and a chill goes through you. This is actually a board that has been roughly hewn from log.

You can see a piece of wood here.

You're getting so tired of treading water, and the waves are kicking up some in wind. You have to get out of the water soon.

>l
Rippling Waves
 You see a piece of wood about six feet in length. You swim over and cling to it gratefully. You look at the wood, and a chill goes through you. This is actually a board that has been roughly hewn from log.

You can see a piece of wood here.

>l
Rippling Waves
 You see a piece of wood about six feet in length. You swim over and cling to it gratefully. You look at the wood, and a chill goes through you. This is actually a board that has been roughly hewn from log.

You can see a piece of wood here.

You are suddenly exhausted, you try to resume floating on your back again, but the waves are higher now and sweep you under.  You reach for the surface as you sink into the gloom.

    *** You have drowned. ***

Would you like to RESTART, RESTORE a saved game, QUIT or UNDO the last command?

>restart
You are floating in the middle of a tropical ocean.  You hoped that the cruise ship would notice you were missing, but it's been hours and hours, and no ship has appeared on the horizon.

Alien Shores
An Interactive Fiction by Keith B Phillips
Release 1 / Serial number 180905 / Inform 7 build 6M62 (I6/v6.33 lib 6/12N) SD

Ocean Waves
 You lay on your back in the warm water as the waves lift your body up and down rythmically.

* * *

>w
Rippling Waves
 You see a piece of wood about six feet in length. You swim over and cling to it gratefully. You look at the wood, and a chill goes through you. This is actually a board that has been roughly hewn from log.

You can see a piece of wood here.

>get on the wood
You mount the piece of wood.

>l
Rippling Waves (on the piece of wood)
 You are sitting on a rough board about six feet in length. All around you is ocean and sky.

>get off the wood
A dark ominous shape swims up from below and you think better about getting back into the water.

* * *

>l
Ocean Waves
 You lay on your back in the warm water as the waves lift your body up and down rythmically. 

You're getting so tired of treading water, and the waves are kicking up some in wind. You have to get out of the water soon.

>ll
That's not a verb I recognise.

>l
Ocean Waves
 You lay on your back in the warm water as the waves lift your body up and down rythmically.

* * *

>w
Rippling Waves
 You see a piece of wood about six feet in length. You swim over and cling to it gratefully. You look at the wood, and a chill goes through you. This is actually a board that has been roughly hewn from log.

You can see a piece of wood here.

>e
Ocean Waves
 You lay on your back in the warm water as the waves lift your body up and down rythmically.

>e
Open Water
 You tread water to stay afloat. You're getting tired. If only you had something to float on. Nothing but more water can be seen.

>n
Even More Open Water
 You tread water to stay afloat. You're getting tired.  A stick of very wet driftwood, about six feet long and and one inch thick.

>w
Floating Object
 You tread water to stay afloat. You're getting tired.  A body seems to have been the source of a partial meal.

On the body is a jacket.

>s
Ocean Waves
 You lay on your back in the warm water as the waves lift your body up and down rythmically.

>w
Rippling Waves
 You see a piece of wood about six feet in length. You swim over and cling to it gratefully. You look at the wood, and a chill goes through you. This is actually a board that has been roughly hewn from log.

You can see a piece of wood here.

You're getting so tired of treading water, and the waves are kicking up some in wind. You have to get out of the water soon.

* * *

>l
Ocean Waves
....  You lay on your back in the warm water as your body floats up and down the rythmic waves. The hot sun beats down on you and there is not a cloud in the clear blue sky.

You can see bug here.

At least one good thing has come of all this, you won't have to worry about ending your vacation any time soon.

What next?  You can say, help, to get more information on how to play.

>ne
Even More Open Water
A stick of very wet driftwood, about six feet long and and one inch thick.

>get stick
Taken.

>sw
Ocean Waves
 You lay on your back in the warm water as the waves lift your body up and down rythmically.  The sun's relentless heat beats down on you and the salt spray stings your eyes. The sea laps against your face and sometimes over it.  When it does, you spout like a tiny human whale.

* * *

>e
Ocean Waves (on the piece of wood)
 The water laps at the plank you sit on, rocking you up and down.

>n
Floating Object (on the piece of wood)
A body seems to have been the source of a partial meal.

On the body is a jacket.

>get jacket
Taken.

I beg your pardon?

>put stick in knothole
You place the driftwood stick into the knothole. It's tight fit but you manage it. Your little plank surfboard now has a mast.

>put jacket on stick
You drape the jacket over the stick by the collar.
The wind catches the jacket and pulls you along over the waves.

Rushing Waves (on the piece of wood)
You rush along the tops of the waves as the wind blows your makeshift sail.  The board is slippery and wet and hits the occasional wave just so, sending a spray into your face, almost knocking you from the board. You cling to the fragile looking stick of driftwood desperately hoping that it will hold and keep you on the board.

>l
Rushing Waves (on the piece of wood)
You rush along the tops of the waves as the wind blows your makeshift sail.  The board is slippery and wet and hits the occasional wave just so, sending a spray into your face, almost knocking you from the board. You cling to the fragile looking stick of driftwood desperately hoping that it will hold and keep you on the board.

>l
Rushing Waves (on the piece of wood)
You rush along the tops of the waves as the wind blows your makeshift sail.  The board is slippery and wet and hits the occasional wave just so, sending a spray into your face, almost knocking you from the board. You cling to the fragile looking stick of driftwood desperately hoping that it will hold and keep you on the board.

>l
Journeying On The Waves (on the piece of wood)
A brisk wind wind is blowing. The sun hangs low in the sky over a distant island. Island

You can see a sail here.

The wind suddenly shifts to the westward! You speed ahead toward the island as the wind catches your fancy jacket-sail.

>l
Journeying On The Waves (on the piece of wood)
A brisk westward wind is blowing. The sun hangs low in the sky over a distant island. You speed ahead toward the island as the wind catches your fancy jacket-sail.

You can see a centered positioned sail here.

>l
Journeying On The Waves (on the piece of wood)
A brisk northwestward wind is blowing. The sun hangs low in the sky over a distant island. Your speed toward the island has slowed to a crawl.

You can see a centered positioned sail here.

The wind suddenly shifts to the northwestward! Your speed toward the island has slowed to a crawl.

>l
Journeying On The Waves (on the piece of wood)
A brisk northwestward wind is blowing. The sun hangs low in the sky over a distant island. Your speed toward the island has slowed to a crawl.

You can see a centered positioned sail here.

The wind suddenly shifts to the westward! You speed ahead toward the island as the wind catches your fancy jacket-sail.

>l
Journeying On The Waves (on the piece of wood)
A brisk westward wind is blowing. The sun hangs low in the sky over a distant island. You speed ahead toward the island as the wind catches your fancy jacket-sail.

You can see a centered positioned sail here.

>l
Journeying On The Waves (on the piece of wood)
A brisk westward wind is blowing. The sun hangs low in the sky over a distant island. You speed ahead toward the island as the wind catches your fancy jacket-sail.

You can see a centered positioned sail here.

The wind suddenly shifts to the westward! You speed ahead toward the island as the wind catches your fancy jacket-sail.

>l
Journeying On The Waves (on the piece of wood)
A brisk westward wind is blowing. The sun hangs low in the sky over a distant island. You speed ahead toward the island as the wind catches your fancy jacket-sail.

You can see a centered positioned sail here.

* * *

>l
Journeying On The Waves (on the piece of wood)
A brisk westward wind is blowing. The sun hangs low in the sky over a distant island. You speed ahead toward the island as the wind catches your fancy jacket-sail.

You can see a centered positioned sail here.

The wind suddenly shifts to the westward! You speed ahead toward the island as the wind catches your fancy jacket-sail.

>l
Journeying On The Waves (on the piece of wood)
A brisk westward wind is blowing. The sun hangs low in the sky over a distant island. You speed ahead toward the island as the wind catches your fancy jacket-sail.

You can see a centered positioned sail here.

The wind suddenly shifts to the northwestward! Your speed toward the island has slowed to a crawl.

>turn sail left
You twist the mast slightly to the left.

>l
Journeying On The Waves (on the piece of wood)
A brisk southwestward wind is blowing. The sun hangs low in the sky over a distant island. You speed ahead toward the island as the wind catches your fancy jacket-sail.

You can see a left positioned sail here.

>l
Journeying On The Waves (on the piece of wood)
A brisk southwestward wind is blowing. The sun hangs low in the sky over a distant island. You speed ahead toward the island as the wind catches your fancy jacket-sail.

You can see a left positioned sail here.

The wind suddenly shifts to the southwestward! You speed ahead toward the island as the wind catches your fancy jacket-sail.

>l
Journeying On The Waves (on the piece of wood)
A brisk southwestward wind is blowing. The sun hangs low in the sky over a distant island. You speed ahead toward the island as the wind catches your fancy jacket-sail.

You can see a left positioned sail here.

The wind suddenly shifts to the northwestward! Your speed toward the island has slowed to a crawl.

>turn sail right
You twist the mast slightly to the right.

>l
Island Beach (on the piece of wood)
You are on a beautiful island beach.

>l
Island Beach (on the piece of wood)
You are on a beautiful island beach.

* * *

>l
Ocean Waves
....  You lay on your back in the warm water as your body floats up and down the rythmic waves. The hot sun beats down on you and there is not a cloud in the clear blue sky.

You can see bug here.

At least one good thing has come of all this, you won't have to worry about ending your vacation any time soon.

What next?  You can say, help, to get more information on how to play.

>w
Rippling Waves
....  You see a piece of wood about six feet in length. You swim over and cling to it gratefully. You look at the wood, and a surge of hope goes through you. This is actually a wide board that has been roughly hewn from a log.

You can see a piece of wood here.

What next?  You can say, help, to get more information on how to play.

>l
Rippling Waves
....  You see a piece of wood about six feet in length. You swim over and cling to it gratefully. You look at the wood, and a surge of hope goes through you. This is actually a wide board that has been roughly hewn from a log.

You can see a piece of wood here.

What next? :

>e
Ocean Waves
....  You lay on your back in the warm water as your body floats up and down the rythmic waves. The hot sun beats down on you and there is not a cloud in the clear blue sky.

You can see bug here.

What next? :

>e
Open Water
....  You continue to swim. All that effort is making you really tired. If only you had something to float on. Nothing but more ocean can be seen in all directions.

What next? :

* * *

>l
Ocean Waves
....  You lay on your back in the warm water as your body floats up and down the rythmic waves. The hot sun beats down on you and there is not a cloud in the clear blue sky.

You can see bug here.

This really sucks. You could be kicking back right now having an ice-cold drink in the ship's lounge.

What next?  You can say, help, to get more information on how to play.

>w
Rippling Waves
 You see a piece of wood about six feet in length. You swim over and cling to it gratefully. You look at the wood, and a chill goes through you. This is actually a board that has been roughly hewn from log.

You can see a piece of wood here.

* * *

>l
Ocean Waves
 You lay on your back in the warm water as the waves lift your body up and down rythmically. 

You deeply regret trying to stop your phone from falling over the railing of the ship.  Now look what's happened.

>e
Open Water
 You tread water to stay afloat. You're getting tired. If only you had something to float on. Nothing but more water can be seen.

* * *

>l
Ocean Waves
 You lay on your back in the warm water as the waves lift your body up and down rythmically. 

You deeply regret trying to stop your phone from falling over the railing of the ship.  Now look what's happened.

>n
Floating Object
 You tread water to stay afloat. You're getting tired.  A body seems to have been the source of a partial meal.

On the body is a jacket.

>e
Even More Open Water
 You tread water to stay afloat. You're getting tired.  A stick of very wet driftwood, about six feet long and and one inch thick.

>get the stick
You can't hold the stick and swim.

* * *

>l
Ocean Waves
....  You lay on your back in the warm water as your body floats up and down the rythmic waves. The hot sun beats down on you and there is not a cloud in the clear blue sky.

You can see bug here.

You deeply regret trying to stop your phone from falling over the railing of the ship. Now look what's happened.

What next?  You can say, help, to get more information on how to play.

>look at stone
You can't see any such thing.

What next?  You can say, help, to get more information on how to play.

* * *

>l
Ocean Waves
....  You lay on your back in the warm water as your body floats up and down the rythmic waves. The hot sun beats down on you and there is not a cloud in the clear blue sky.

You can see bug here.

You deeply regret trying to stop your phone from falling over the railing of the ship. Now look what's happened.

What next?  You can say, help, to get more information on how to play.

>n
Glittering Waves
....  You tread water, and you are getting exhausted.  What is left of a human body floats on the surface here.  Something has been eating it.

On the body is a jacket.

This really sucks. You could be kicking back right now having an ice-cold drink in the ship's lounge.

What next?  You can say, help, to get more information on how to play.

>e
Even More Open Water
....  You continue to swim and are getting tired.  There is a stick of very wet driftwood here, about six feet long and and three inches thick.

At least one good thing has come of all this, you won't have to worry about ending your vacation any time soon.

What next?  You can say, help, to get more information on how to play.

>w
Glittering Waves
....  You tread water, and you are getting exhausted.  What is left of a human body floats on the surface here.  Something has been eating it.

On the body is a jacket.

What next?  You can say, help, to get more information on how to play.

>s
Ocean Waves
....  You lay on your back in the warm water as your body floats up and down the rythmic waves. The hot sun beats down on you and there is not a cloud in the clear blue sky.

You can see a bug here.

What next?  You can say, help, to get more information on how to play.

>n
Glittering Waves
....  You tread water, and you are getting exhausted.  What is left of a human body floats on the surface here.  Something has been eating it.

On the body is a jacket.

What next?  You can say, help, to get more information on how to play.

>n
You begin to paddle in that direction but without a plan or destination you soon lose hope and return.

You're getting so tired, and the waves are kicking up some in the wind. You have to get out of the water soon.

What next?  You can say, help, to get more information on how to play.

>n
You begin to paddle in that direction but without a plan or destination you soon lose hope and return.

What next?  You can say, help, to get more information on how to play.

* * *

>n
Glittering Waves
....  You tread water, and you are getting exhausted.  What is left of a human body floats on the surface here.  Something has been eating it.

On the body is a jacket.

This really sucks. You could be kicking back right now having an ice-cold drink in the ship's lounge.

What next?  You can say, help, to get more information on how to play.

>get jacket
Taken.

>l
Floating Object
A body seems to have been the source of a partial meal.

>s
Ocean Waves
 You lay on your back in the warm water as the waves lift your body up and down rythmically.  The sun's relentless heat beats down on you and the salt spray stings your eyes. The sea laps against your face and sometimes over it.  When it does, you spout like a tiny human whale.

>e
Open Water
 You tread water to stay afloat.  You're getting tired. Nothing but more water can be seen.

>w
Ocean Waves
 You lay on your back in the warm water as the waves lift your body up and down rythmically.  The sun's relentless heat beats down on you and the salt spray stings your eyes. The sea laps against your face and sometimes over it.  When it does, you spout like a tiny human whale.

>s
More Open Water
 You tread water to stay afloat.  You're getting tired.  Nothing but more water can be seen.

>n
Ocean Waves
 You lay on your back in the warm water as the waves lift your body up and down rythmically.  The sun's relentless heat beats down on you and the salt spray stings your eyes. The sea laps against your face and sometimes over it.  When it does, you spout like a tiny human whale.

>w
Rippling Waves
You cling to a piece of wood.  It seems to have been part of a boat at one time..

* * *

>e
Ocean Waves (on the piece of wood)
 The water laps at the plank you sit on, rocking you up and down.

>n
Floating Object (on the piece of wood)
A body seems to have been the source of a partial meal.

>s
Ocean Waves (on the piece of wood)
 The water laps at the plank you sit on, rocking you up and down.

>ne
Even More Open Water (on the piece of wood)
A stick of very wet driftwood, about six feet long and and one inch thick.

>get stick
Taken.

>l
Even More Open Water (on the piece of wood)

>i
You are carrying:
  a stick
  a jacket

>look at jacket
It's an olive-drav green military fatigue jacket with over sized pockets.

>look at pockets
In pockets is a knife.

>look wood
It's a sturdy plank of the type used to make wooden hulls. There is a small knothole in the middle of it.

>put stick in knothole
You place the driftwood stick into the knothole. It's tight fit but you manage it. Your little plank surfboard now has a mast.

>put jacket on stick
You drape the jacket over the stick by the collar.
The wind catches the jacket and pulls you along over the waves.

Rushing Waves
You rush along the tops of the waves as the wind blows your makeshift sail.  The board is slippery and wet and hits the occasional wave just so, sending a spray into your face, almost knocking you from the board. You cling to the fragile looking stick of driftwood desperately hoping that it will hold and keep you on the board.

>l
Rushing Waves
You rush along the tops of the waves as the wind blows your makeshift sail.  The board is slippery and wet and hits the occasional wave just so, sending a spray into your face, almost knocking you from the board. You cling to the fragile looking stick of driftwood desperately hoping that it will hold and keep you on the board.

You cling to a piece of wood.  It seems to have been part of a boat at one time..

>l
Rushing Waves
You rush along the tops of the waves as the wind blows your makeshift sail.  The board is slippery and wet and hits the occasional wave just so, sending a spray into your face, almost knocking you from the board. You cling to the fragile looking stick of driftwood desperately hoping that it will hold and keep you on the board.

You cling to a piece of wood.  It seems to have been part of a boat at one time..

>l
Rushing Waves
You rush along the tops of the waves as the wind blows your makeshift sail.  The board is slippery and wet and hits the occasional wave just so, sending a spray into your face, almost knocking you from the board. You cling to the fragile looking stick of driftwood desperately hoping that it will hold and keep you on the board.

You cling to a piece of wood.  It seems to have been part of a boat at one time..

Journing On The Waves
You continue to be totally swept along westward toward the sun that hangs over the sea in the sky. You begin to see something peeking above the horizon of waves in the distance.

* * *

>l
Ocean Waves
....  You lay on your back in the warm water as your body floats up and down the rythmic waves. The hot sun beats down on you and there is not a cloud in the clear blue sky.

You can see bug here.

You deeply regret trying to stop your phone from falling over the railing of the ship. Now look what's happened.

What next?  You can say, help, to get more information on how to play.

>ne
Even More Open Water
 You tread water to stay afloat. You're getting tired.  A stick of very wet driftwood, about six feet long and and one inch thick.

>get stick
You can't hold the stick and swim.

>w
You begin to paddle in that direction but without a plan or destination you soon lose hope and return.

>sw
Ocean Waves
 You lay on your back in the warm water as the waves lift your body up and down rythmically.  The sun's relentless heat beats down on you and the salt spray stings your eyes. The sea laps against your face and sometimes over it.  When it does, you spout like a tiny human whale.

* * *

>w
Rippling Waves
You cling to a piece of wood.  It seems to have been part of a boat at one time..

>get on the wood
You mount the piece of wood.

>e
Ocean Waves (on the piece of wood)
 The water laps at the plank you sit on, rocking you up and down.

* * *

>e
Open Water (on the piece of wood)
 Nothing but more water can be seen.

>ne
You begin to paddle in that direction but without a plan or destination you soon lose hope and return.

>w
Ocean Waves (on the piece of wood)
 The water laps at the plank you sit on, rocking you up and down.

* * *

>ne
Even More Open Water (on the piece of wood)
 A stick of very wet driftwood, about six feet long and and one inch thick.

>get stick
Taken.

>sw
Ocean Waves (on the piece of wood)
 The water laps at the plank you sit on, rocking you up and down.

>n
Floating Object (on the piece of wood)
 A body seems to have been the source of a partial meal.

On the body is a jacket.

>get jacket
Taken.

>put jacket on stick
You drape the jacket over the stick by the collar.

>put the stick in the knothole
You place the driftwood stick into the knothole. It's a tight fit, but you manage it. Your little plank surfboard now has a mast.
The wind catches the jacket and pulls you along over the waves.

Rushing Waves (on the piece of wood)
You rush along the tops of the waves as the wind blows your makeshift sail. The board is slippery and wet and hits the occasional wave just so, sending a spray into your face, almost knocking you from the board. You cling to the fragile looking stick of driftwood desperately hoping that it will hold and keep you on the board.

>l
Rushing Waves (on the piece of wood)
You rush along the tops of the waves as the wind blows your makeshift sail. The board is slippery and wet and hits the occasional wave just so, sending a spray into your face, almost knocking you from the board. You cling to the fragile looking stick of driftwood desperately hoping that it will hold and keep you on the board.

>w
You begin to paddle in that direction but without a plan or destination you soon lose hope and return.

>s
You begin to paddle in that direction but without a plan or destination you soon lose hope and return.

>n
You begin to paddle in that direction but without a plan or destination you soon lose hope and return.

>w
You begin to paddle in that direction but without a plan or destination you soon lose hope and return.

>e
You begin to paddle in that direction but without a plan or destination you soon lose hope and return.

The wind suddenly shifts to the westward! You speed ahead toward the island as the wind catches your fancy jacket-sail.

>l
Journeying On The Waves (on the piece of wood)
A brisk westward wind is blowing. The sun hangs low in the sky over a distant island. You speed ahead toward the island as the wind catches your fancy jacket-sail.

You can see a centered positioned sail here.

>w
You begin to paddle in that direction but without a plan or destination you soon lose hope and return.

>l
Journeying On The Waves (on the piece of wood)
A brisk westward wind is blowing. The sun hangs low in the sky over a distant island. You speed ahead toward the island as the wind catches your fancy jacket-sail.

You can see a centered positioned sail here.

>l
Journeying On The Waves (on the piece of wood)
A brisk southwestward wind is blowing. The sun hangs low in the sky over a distant island. Your speed toward the island has slowed to a crawl.

You can see a centered positioned sail here.

>turn sail left
You twist the mast slightly to the left.

The wind suddenly shifts to the southwestward! You speed ahead toward the island as the wind catches your fancy jacket-sail.

>l
Journeying On The Waves (on the piece of wood)
A brisk southwestward wind is blowing. The sun hangs low in the sky over a distant island. You speed ahead toward the island as the wind catches your fancy jacket-sail.

You can see a left positioned sail here.

The wind suddenly shifts to the southwestward! You speed ahead toward the island as the wind catches your fancy jacket-sail.

>l
Journeying On The Waves (on the piece of wood)
A brisk southwestward wind is blowing. The sun hangs low in the sky over a distant island. You speed ahead toward the island as the wind catches your fancy jacket-sail.

You can see a left positioned sail here.

>l
Journeying On The Waves (on the piece of wood)
A brisk northwestward wind is blowing. The sun hangs low in the sky over a distant island. Your speed toward the island has slowed to a crawl.

You can see a left positioned sail here.

The wind suddenly shifts to the northwestward! Your speed toward the island has slowed to a crawl.

>turn stick right
You can't see any such thing.

>turn sail right
You twist the mast slightly to the right.

>turn sail right
You twist the mast slightly to the right.

>l
Journeying On The Waves (on the piece of wood)
A brisk southwestward wind is blowing. The sun hangs low in the sky over a distant island. Your speed toward the island has slowed to a crawl.

You can see a right positioned sail here.

>turn sail left
You twist the mast slightly to the left.

>turn sail left
You twist the mast slightly to the left.

>l
Island Beach (on the piece of wood)
You are on a beautiful island beach.

>e
You can't go that way.

>n
You can't go that way.

>w
You can't go that way.

>s
You can't go that way.

>ne
You can't go that way.

>nw
You can't go that way.

>sw
You can't go that way.

>se
You can't go that way.

>u
You can't go that way.

>d
You can't go that way.

* * *

>l
Ocean Waves
....  You lay on your back in the warm water as your body floats up and down the rythmic waves. The hot sun beats down on you and there is not a cloud in the clear blue sky.

You can see bug here.

You deeply regret trying to stop your phone from falling over the railing of the ship. Now look what's happened.

What next?  You can say, help, to get more information on how to play.

>s
More Open Water
 You tread water to stay afloat. You're getting tired.  Nothing but more water can be seen.

What now?

>n
Ocean Waves
You lay on your back in the warm salt water as the waves lift your body up and down rythmically.

>e
Open Water
Nothing but more water can be seen.

>w
Ocean Waves
You lay on your back in the warm salt water as the waves lift your body up and down rythmically.

>w
Piece Of Debri
You cling to the piece of wood.  It seems to have been part of a boat at one time.

* * *

>s
More Open Water
 You tread water to stay afloat. You're getting tired.  Nothing but more water can be seen.

What now?

>w
You begin to paddle in that direction but without a plan or destination you soon lose hope and return.

What now?

* * *

>l
Ocean Waves
....  You lay on your back in the warm water as your body floats up and down the rythmic waves. The hot sun beats down on you and there is not a cloud in the clear blue sky.

You can see bug here.

You deeply regret trying to stop your phone from falling over the railing of the ship. Now look what's happened.

What next?  You can say, help, to get more information on how to play.

>w
Rippling Waves
....  You see a piece of wood about six feet in length. You swim over and cling to it gratefully. You look at the wood, and a surge of hope goes through you. This is actually a wide board that has been roughly hewn from a log.

You can see a piece of wood here.

This really sucks. You could be kicking back right now having an ice-cold drink in the ship's lounge.

What next?  You can say, help, to get more information on how to play.

>e
Ocean Waves
....  You lay on your back in the warm water as your body floats up and down the rythmic waves. The hot sun beats down on you and there is not a cloud in the clear blue sky.

You can see a bug here.

At least one good thing has come of all this, you won't have to worry about ending your vacation any time soon.

What next?  You can say, help, to get more information on how to play.

>n
Glittering Waves
....  You tread water, and you are getting exhausted.  What is left of a human body floats on the surface here.  Something has been eating it.

On the body is a jacket.

What next?  You can say, help, to get more information on how to play.

>e
Even More Open Water
....  You continue to swim and are getting tired.  There is a stick of very wet driftwood here, about six feet long and and three inches thick.

What next?  You can say, help, to get more information on how to play.

>s
Open Water
....  You continue to swim. All that effort is making you really tired. If only you had something to float on. Nothing but more ocean can be seen in all directions.

What next?  You can say, help, to get more information on how to play.

>w
Ocean Waves
....  You lay on your back in the warm water as your body floats up and down the rythmic waves. The hot sun beats down on you and there is not a cloud in the clear blue sky.

You can see a bug here.

What next?  You can say, help, to get more information on how to play.

* * *

>e
Ocean Waves
....  You lay on your back in the warm water as your body floats up and down the rythmic waves. The hot sun beats down on you and there is not a cloud in the clear blue sky.

You can see a bug here.

At least one good thing has come of all this, you won't have to worry about ending your vacation any time soon.

What next?  You can say, help, to get more information on how to play.

>w
Rippling Waves
You cling to a piece of wood.  It seems to have been part of a boat at one time..

* * *

>get on wood
You mount the piece of wood.

>e
Ocean Waves (on the piece of wood)
 The water laps at the plank you sit on, rocking you up and down.  A dark object bobs up and down on the surface to the North.

>look at the wood
It's a sturdy plank of the type used to make wooden hulls. There is a round knothole in the middle of it.

>n
Floating Object (on the piece of wood)
 A body seems to have been the source of a partial meal.

On the body is a jacket.

>get body
That's hardly portable.

>get jacket
Taken.

>e
Even More Open Water (on the piece of wood)
 A stick of very wet driftwood, about six feet long and and one inch thick.

>get stick
Taken.

>s
Open Water (on the piece of wood)
 Nothing but more water can be seen.

>w
Ocean Waves (on the piece of wood)
 The water laps at the plank you sit on, rocking you up and down.  A dark object bobs up and down on the surface to the North.

>s
More Open Water (on the piece of wood)
 Nothing but more water can be seen.

>n
Ocean Waves (on the piece of wood)
 The water laps at the plank you sit on, rocking you up and down.  A dark object bobs up and down on the surface to the North.

>e
Open Water (on the piece of wood)
 Nothing but more water can be seen.

>put jacket on the stick
You drape the jacket over the stick by the collar.

>put stick in the knothole
You place the driftwood stick into the knothole. It's a tight fit, but you manage it. Your little plank surfboard now has a mast.
The wind catches the jacket and pulls you along over the waves.

Rushing Waves (on the piece of wood)
You rush along the tops of the waves as a westward wind blows your makeshift sail.  The sail is in the center position and the wind fills it nicely. The board is slippery and wet and hits the occasional wave just so, sending a spray into your face, almost knocking you from the board. You cling to the fragile looking stick of driftwood desperately hoping that it will hold and keep you on the board.

>l
Rushing Waves (on the piece of wood)
You rush along the tops of the waves as a westward wind blows your makeshift sail.  The sail is in the center position and the wind fills it nicely. The board is slippery and wet and hits the occasional wave just so, sending a spray into your face, almost knocking you from the board. You cling to the fragile looking stick of driftwood desperately hoping that it will hold and keep you on the board.

>l
Rushing Waves (on the piece of wood)
You rush along the tops of the waves as a westward wind blows your makeshift sail.  The sail is in the center position and the wind fills it nicely. The board is slippery and wet and hits the occasional wave just so, sending a spray into your face, almost knocking you from the board. You cling to the fragile looking stick of driftwood desperately hoping that it will hold and keep you on the board.

>l
Journeying On The Waves (on the piece of wood)
A brisk wind wind is blowing. The sun hangs low in the sky over a distant island. Island

You can see a sail here.

>l
Journeying On The Waves (on the piece of wood)
A brisk westward wind is blowing. The sun hangs low in the sky over a distant island. You speed ahead toward the island as the wind catches your fancy jacket-sail.

You can see a centered positioned sail here.

* * *

>w
Rippling Waves
....  You see a piece of wood about six feet in length. You swim over and cling to it gratefully. You look at the wood, and a surge of hope goes through you. This is actually a wide board that has been roughly hewn from a log.

You can see a piece of wood here.

This really sucks. You could be kicking back right now having an ice-cold drink in the ship's lounge.

What next?  You can say, help, to get more information on how to play.

>get on wood
Thank goodness!  You were getting exhausted just trying to stay a float.

You mount the piece of wood.

What next?

I beg your pardon?

What next?

>e
Ocean Waves (on the piece of wood)
....  The water laps at the plank you sit on, rocking you up and down. You can see a dark object bobbing on the surface to the North.

What next?

>n
Glittering Waves (on the piece of wood)
....  What is left of a human body floats on the surface here.  Something has been eating it.

On the body is a jacket.

What next?

>get jacket
The body is badly decayed. You can't tell if it was male or female.  Your stomach churns from the smell, but you grit your teeth and strip the jacket off.

Taken.

What next?

>e
Even More Open Water (on the piece of wood)
....  There is a stick of very wet driftwood here, about six feet long and and one inch thick.

What next?

>get stick
Taken.

What next?

>put stick in hole
You place the driftwood stick into the knothole. It's a tight fit, but you manage it. Your little plank surfboard now has a mast.

What next?

>put jacke on stick
You can't see any such thing.

What next?

>put jacket on stick
You drape the jacket over the stick by the collar.
The wind catches the jacket and pulls you along over the waves.

Journeying On The Waves (on the piece of wood)
.... A brisk westward wind is blowing and the sun hangs low in the sky. In the distance you can barely make out the shape of an island jutting above the waves

You can see a centered positioned sail here.

Wind is 2 and sail is 2 and the island is 0.
The wind suddenly shifts to a southwestward wind!
There is the faint outline of an island in the distance.

What next?

>l
Journeying On The Waves (on the piece of wood)
.... A brisk southwestward wind is blowing and the sun hangs low in the sky. Your speed toward the island has slowed to a crawl.

You can see a centered positioned sail here.

Wind is 3 and sail is 2 and the island is 1.
There is the faint outline of an island in the distance.

What next?

>w
You begin to paddle, but it has little effect. Better stick to sailing. You watch the wind pushing the sail to see if you need to turn it left or right.

Wind is 3 and sail is 2 and the island is 1.
There is the faint outline of an island in the distance.

What next?

>l
Journeying On The Waves (on the piece of wood)
.... A brisk southwestward wind is blowing and the sun hangs low in the sky. Your speed toward the island has slowed to a crawl.

You can see a centered positioned sail here.

Wind is 3 and sail is 2 and the island is 1.
A southwestward wind continues to blow.
There is the faint outline of an island in the distance.

What next?

>l
Journeying On The Waves (on the piece of wood)
.... A brisk southwestward wind is blowing and the sun hangs low in the sky. Your speed toward the island has slowed to a crawl.

You can see a centered positioned sail here.

Wind is 3 and sail is 2 and the island is 1.
There is the faint outline of an island in the distance.

What next?

>l
Journeying On The Waves (on the piece of wood)
.... A brisk southwestward wind is blowing and the sun hangs low in the sky. Your speed toward the island has slowed to a crawl.

You can see a centered positioned sail here.

Wind is 3 and sail is 2 and the island is 1.
There is the faint outline of an island in the distance.

What next?

>l
Journeying On The Waves (on the piece of wood)
.... A brisk southwestward wind is blowing and the sun hangs low in the sky. Your speed toward the island has slowed to a crawl.

You can see a centered positioned sail here.

Wind is 3 and sail is 2 and the island is 1.
A southwestward wind continues to blow.
There is the faint outline of an island in the distance.

What next?

>l
Journeying On The Waves (on the piece of wood)
.... A brisk southwestward wind is blowing and the sun hangs low in the sky. Your speed toward the island has slowed to a crawl.

You can see a centered positioned sail here.

Wind is 3 and sail is 2 and the island is 1.
The wind suddenly shifts to a northwestward wind!
There is the faint outline of an island in the distance.

What next?

>l
Journeying On The Waves (on the piece of wood)
.... A brisk northwestward wind is blowing and the sun hangs low in the sky. Your speed toward the island has slowed to a crawl.

You can see a centered positioned sail here.

Wind is 1 and sail is 2 and the island is -1.
There is the faint outline of an island in the distance.

What next?

>l
Journeying On The Waves (on the piece of wood)
.... A brisk northwestward wind is blowing and the sun hangs low in the sky. Your speed toward the island has slowed to a crawl.

You can see a centered positioned sail here.

Wind is 1 and sail is 2 and the island is -1.
There is the faint outline of an island in the distance.

What next?

>n
You begin to paddle, but it has little effect. Better stick to sailing. You watch the wind pushing the sail to see if you need to turn it left or right.

Wind is 1 and sail is 2 and the island is -1.
A northwestward wind continues to blow.
There is the faint outline of an island in the distance.

What next?

>get off wood
A dark ominous shape swims up from below and you suddenly decide that it would be better not to get back into the water.

Wind is 1 and sail is 2 and the island is -1.
There is the faint outline of an island in the distance.

What next?

>n
You begin to paddle, but it has little effect. Better stick to sailing. You watch the wind pushing the sail to see if you need to turn it left or right.

Wind is 1 and sail is 2 and the island is -1.
The wind suddenly shifts to a southwestward wind!
There is the faint outline of an island in the distance.

What next?

>w
You begin to paddle, but it has little effect. Better stick to sailing. You watch the wind pushing the sail to see if you need to turn it left or right.

Wind is 3 and sail is 2 and the island is 1.
A southwestward wind continues to blow.
There is the faint outline of an island in the distance.

What next?

>ride turtle
You can't see any such thing.

What next?

>s
You begin to paddle, but it has little effect. Better stick to sailing. You watch the wind pushing the sail to see if you need to turn it left or right.

Wind is 3 and sail is 2 and the island is 1.
There is the faint outline of an island in the distance.

What next?

>s
You begin to paddle, but it has little effect. Better stick to sailing. You watch the wind pushing the sail to see if you need to turn it left or right.

Wind is 3 and sail is 2 and the island is 1.
There is the faint outline of an island in the distance.

What next?

>l
Journeying On The Waves (on the piece of wood)
.... A brisk southwestward wind is blowing and the sun hangs low in the sky. Your speed toward the island has slowed to a crawl.

You can see a centered positioned sail here.

Wind is 3 and sail is 2 and the island is 1.
There is the faint outline of an island in the distance.

What next?

>l
Journeying On The Waves (on the piece of wood)
.... A brisk southwestward wind is blowing and the sun hangs low in the sky. Your speed toward the island has slowed to a crawl.

You can see a centered positioned sail here.

Wind is 3 and sail is 2 and the island is 1.
The wind suddenly shifts to a westward wind!
There is the faint outline of an island in the distance.

A grey fin emerges from the waves. Adrenaline kicks in, but you manage to hold yourself together.  You guide your make-shift sailboard away from the creature until the fin submerges. For a moment you feel somewhat relieved, and then you wonder where the creature has gone to.

What next?

>l
Journeying On The Waves (on the piece of wood)
.... A brisk westward wind is blowing and the sun hangs low in the sky. You speed ahead toward the island as the wind catches your centered positioned sail.

Wind is 2 and sail is 2 and the island is 0.
There is the faint outline of an island in the distance.

A grey fin emerges from the waves. Adrenaline kicks in, but you manage to hold yourself together.  You guide your make-shift sailboard away from the creature until the fin submerges. For a moment you feel somewhat relieved, and then you wonder where the creature has gone to.

What next?

>l
Journeying On The Waves (on the piece of wood)
.... A brisk westward wind is blowing and the sun hangs low in the sky. You speed ahead toward the island as the wind catches your centered positioned sail.

Wind is 2 and sail is 2 and the island is 0.
A westward wind continues to blow.

A grey fin emerges from the waves. Adrenaline kicks in, but you manage to hold yourself together.  You guide your make-shift sailboard away from the creature until the fin submerges. For a moment you feel somewhat relieved, and then you wonder where the creature has gone to.

What next?

>l
Journeying On The Waves (on the piece of wood)
.... A brisk westward wind is blowing and the sun hangs low in the sky. You speed ahead toward the island as the wind catches your centered positioned sail.

Wind is 2 and sail is 2 and the island is 0.
The wind suddenly shifts to a southwestward wind!

A grey fin emerges from the waves. Adrenaline kicks in, but you manage to hold yourself together.  You guide your make-shift sailboard away from the creature until the fin submerges. For a moment you feel somewhat relieved, and then you wonder where the creature has gone to.

What next?

>l
Journeying On The Waves (on the piece of wood)
.... A brisk southwestward wind is blowing and the sun hangs low in the sky. Your speed toward the island has slowed to a crawl.

You can see a centered positioned sail here.

Wind is 3 and sail is 2 and the island is 1.

A grey fin emerges from the waves. Adrenaline kicks in, but you manage to hold yourself together.  You guide your make-shift sailboard away from the creature until the fin submerges. For a moment you feel somewhat relieved, and then you wonder where the creature has gone to.
Suddenly the shark reappears next to your board.  This time it is too quick.  Eons of evolution has turned it into the perfect predator. You look over and see a big toothy grin. You imagine he's your pal, just surfing along with you on the waves, having a good time. It's easier that way.  The end comes in the blink of eye.

    *** You have been eaten. ***

Would you like to RESTART, RESTORE a saved game, QUIT or UNDO the last command?

>restart
.... You are floating in the middle of a tropical ocean.  You hoped that the cruise ship would notice you were missing, but it's been hours, and no ship has appeared on the horizon. You deeply regret trying to stop your phone from falling over the railing of the ship. Now look what's happened.

Alien Shores....
An Interactive Fiction by Keith B Phillips.... Say look, or north, east, west south to move.
Release 1 / Serial number 180910 / Inform 7 build 6M62 (I6/v6.33 lib 6/12N) SD

Ocean Waves
....  You lay on your back in the warm water as your body floats up and down the rythmic waves. The hot sun beats down on you and there is not a cloud in the clear blue sky.  Say look, or north, east, west south to move.

>w
Rippling Waves
....  You see a piece of wood about six feet in length. You swim over and cling to it gratefully. You look at the wood, and a surge of hope goes through you. This is actually a wide board that has been roughly hewn from a log.

You can see a piece of wood here.

You think you must have hit your head against the ship during the fall, because a small raised lump on the back of your skull is throbbing.

What next?

>get on wood
Thank goodness!  You were getting exhausted just trying to stay a float.

You mount the piece of wood.

What next?

>e
Ocean Waves (on the piece of wood)
....  The water laps at the plank you sit on, rocking you up and down. You can see a dark object bobbing on the surface to the North.

What next?

* * *

>put stick in hole
You place the driftwood stick into the knothole. It's a tight fit, but you manage it. Your little plank surfboard now has a mast.

What next?

>put jacket on stick
You drape the jacket over the stick by the collar.
The wind catches the jacket and pulls you along over the waves.

Journeying On The Waves (on the piece of wood)
.... A brisk westward wind is blowing and the sun hangs low in the sky. In the distance you can barely make out the shape of an island jutting above the waves

You can see a centered positioned sail here.

Wind is 2 and sail is 2 and the island is 0.
A westward wind continues to blow.
There is the faint outline of an island in the distance.

What next?

>l
Journeying On The Waves (on the piece of wood)
.... A brisk westward wind is blowing and the sun hangs low in the sky. You speed ahead toward the island as the wind catches your centered positioned sail.

Wind is 2 and sail is 2 and the island is 0.
The wind suddenly shifts to a northwestward wind!
There is the faint outline of an island in the distance.

What next?

>l
Journeying On The Waves (on the piece of wood)
.... A brisk northwestward wind is blowing and the sun hangs low in the sky. Your speed toward the island has slowed to a crawl.

You can see a centered positioned sail here.

Wind is 1 and sail is 2 and the island is -1.
The wind suddenly shifts to a southwestward wind!
There is the faint outline of an island in the distance.

What next?

>turn sail left
You twist the mast slightly to the left.

Wind is 3 and sail is 1 and the island is 2.
There is the faint outline of an island in the distance.

What next?

>turn sail right
You twist the mast slightly to the right.

Wind is 3 and sail is 2 and the island is 1.
The wind suddenly shifts to a westward wind!
There is the faint outline of an island in the distance.

What next?

>l
Journeying On The Waves (on the piece of wood)
.... A brisk westward wind is blowing and the sun hangs low in the sky. You speed ahead toward the island as the wind catches your centered positioned sail.

Wind is 2 and sail is 2 and the island is 0.

What next?

>l
Journeying On The Waves (on the piece of wood)
.... A brisk westward wind is blowing and the sun hangs low in the sky. You speed ahead toward the island as the wind catches your centered positioned sail.

Wind is 2 and sail is 2 and the island is 0.
The wind suddenly shifts to a northwestward wind!

What next?

>l
Journeying On The Waves (on the piece of wood)
.... A brisk northwestward wind is blowing and the sun hangs low in the sky. Your speed toward the island has slowed to a crawl.

You can see a centered positioned sail here.

Wind is 1 and sail is 2 and the island is -1.
The wind suddenly shifts to a southwestward wind!

What next?

>turn sail right
You twist the mast slightly to the right.

Wind is 3 and sail is 3 and the island is 0.
The wind suddenly shifts to a northwestward wind!

What next?

>turn sail left
You twist the mast slightly to the left.

Wind is 1 and sail is 2 and the island is -1.

What next?

>turn sail left
You twist the mast slightly to the left.

Wind is 1 and sail is 1 and the island is 0.
The wind suddenly shifts to a southwestward wind!

What next?

>l
Journeying On The Waves (on the piece of wood)
.... A brisk southwestward wind is blowing and the sun hangs low in the sky. Your speed toward the island has slowed to a crawl.

You can see a left positioned sail here.

Wind is 3 and sail is 1 and the island is 2.

What next?

>turn sail right
You twist the mast slightly to the right.

Wind is 3 and sail is 2 and the island is 1.
The wind suddenly shifts to a westward wind!
The island is getting closer.

What next?

>l
Journeying On The Waves (on the piece of wood)
.... A brisk westward wind is blowing and the sun hangs low in the sky. You speed ahead toward the island as the wind catches your centered positioned sail.

Wind is 2 and sail is 2 and the island is 0.
The island is getting closer.

What next?

>l
Journeying On The Waves (on the piece of wood)
.... A brisk westward wind is blowing and the sun hangs low in the sky. You speed ahead toward the island as the wind catches your centered positioned sail.

Wind is 2 and sail is 2 and the island is 0.

What next?

>l
Journeying On The Waves (on the piece of wood)
.... A brisk westward wind is blowing and the sun hangs low in the sky. You speed ahead toward the island as the wind catches your centered positioned sail.

Wind is 2 and sail is 2 and the island is 0.
You've almost made it to the island.

What next?

>l
Journeying On The Waves (on the piece of wood)
.... A brisk westward wind is blowing and the sun hangs low in the sky. You speed ahead toward the island as the wind catches your centered positioned sail.

Wind is 2 and sail is 2 and the island is 0.
You've almost made it to the island.

What next?

>l
Journeying On The Waves (on the piece of wood)
.... A brisk westward wind is blowing and the sun hangs low in the sky. You speed ahead toward the island as the wind catches your centered positioned sail.

Wind is 2 and sail is 2 and the island is 0.

What next?

>l
White Sand Beach (on the piece of wood)
.... You are on a beautiful island beach. To the east there is nothing but ocean for as far as the eye can see. This white sand beach extends north and south.  To the west is a lush jungle of green vegetation.

What next?

>n
You can't sail on land. You should probably get off the board.

What next?

>get off board
You dismount the piece of wood.

White Sand Beach
.... You are on a beautiful island beach. To the east there is nothing but ocean for as far as the eye can see. This white sand beach extends north and south.  To the west is a lush jungle of green vegetation.

You can see a piece of wood here.

What next?

>n
North Beach
.... You are on the beach a little north from where you came ashore.  You can see your sailboard to the south. The palm trees whisper in the wind to the west in the lush jungle.

You can see a Sea Turtle here.

The sun continues to sink slowly into the west behind the tree line, and twilight covers the island.  You hear noises in the jungle of things moving about the underbrush. A primal part of your brain kicks in as your heart rate goes up.

What next?

>s
White Sand Beach
.... You are on a beautiful island beach. To the east there is nothing but ocean for as far as the eye can see. This white sand beach extends north and south.  To the west is a lush jungle of green vegetation.

You can see a piece of wood here.

What next?

>s
South Beach
.... You are on the beach a little south from where you came ashore.  You can see your sailboard to the north. The surf washes over the sand with a sigh and hiss. The jungle is to the west.

Darkness covers the island, and the stars stand out brightly in the canvas of the sky.  The things going bump in the night haven't killed you yet and you've had an extemely long day. You find your eyelids slipping closed and your head nods.  You fight to stay awake, worried about the unknown, but you are so tired that you dont" care any more.  You fall into a deep, restful and dreamless sleep.

What next?

* * *

>get on wood
Thank goodness!  You were getting exhausted just trying to stay a float.

You mount the piece of wood.

What next?

>e
Ocean Waves (on the piece of wood)
....  The water laps at the plank you sit on, rocking you up and down. You can see a dark object bobbing on the surface to the North.

You can see a  Say look, or north, east, west south to move. here.

What next?

>n
Glittering Waves (on the piece of wood)
....  What is left of a human body floats on the surface here.  Something has been eating it.

On the body is a jacket.

What next?

* * *

>get on wood
Thank goodness!  You were getting exhausted just trying to stay a float.

You mount the piece of wood.

What next?

>ne
Glittering Waves (on the piece of wood)
 What is left of a human body floats on the surface here.  Something has been eating on it.

On the body is a jacket.

>get jacket
The body is badly decayed. You can't tell if it was male or female.  Your stomach churns from the smell, but you grit your teeth and strip the jacket off.

* * *

>e
Even More Open Water (on the piece of wood)
 There is a stick of very wet driftwood here, about six feet long and and one inch thick.

>get stick
Taken.

* * *

>put stick in hole
You place the driftwood stick into the knothole. It's a tight fit, but you manage it. Your little plank surfboard now has a mast.

>put jacket on stick
You drape the jacket over the stick by the collar.
The wind catches the jacket and pulls you along over the waves.

Journeying On The Waves (on the piece of wood)
A brisk wind is blowing and the sun hangs low in the sky. In the distance you can barely make out the shape of an island jutting above the waves

You can see a sail here.

old wind direction was 2 new direction is 3The wind suddenly shifts to a northwestward wind!
There is the faint outline of an island in the distance.

>l
Journeying On The Waves (on the piece of wood)
A brisk northwestward wind is blowing and the sun hangs low in the sky. You speed ahead toward the island as the wind catches your fancy jacket-sail.

You can see a centered positioned sail here.

There is the faint outline of an island in the distance.

>l
Journeying On The Waves (on the piece of wood)
A brisk northwestward wind is blowing and the sun hangs low in the sky. Your speed toward the island has slowed to a crawl.

You can see a centered positioned sail here.

There is the faint outline of an island in the distance.

>l
Journeying On The Waves (on the piece of wood)
A brisk northwestward wind is blowing and the sun hangs low in the sky. Your speed toward the island has slowed to a crawl.

You can see a centered positioned sail here.

There is the faint outline of an island in the distance.

* * *

>look
Ocean Waves
 You lay on your back in the warm water as the waves lift your body up and down rythmically.  The sun's relentless heat beats down on you and the salt spray stings your eyes. The sea laps against your face and sometimes over it.  When it does, you spout like a tiny human whale.

>west
Rippling Waves
You cling to a piece of wood.  It seems to have been part of a boat at one time..

>east
Ocean Waves
 You lay on your back in the warm water as the waves lift your body up and down rythmically.  The sun's relentless heat beats down on you and the salt spray stings your eyes. The sea laps against your face and sometimes over it.  When it does, you spout like a tiny human whale.

>north
Floating Object
A body seems to have been the source of a partial meal.

On the body is a jacket.

>get jacket
Taken.

>look
Floating Object
A body seems to have been the source of a partial meal.

>east
You can't go that way.

>south
Ocean Waves
 You lay on your back in the warm water as the waves lift your body up and down rythmically.  The sun's relentless heat beats down on you and the salt spray stings your eyes. The sea laps against your face and sometimes over it.  When it does, you spout like a tiny human whale.

>south
More Open Water
 You tread water to stay afloat.  You're getting tired.  Nothing but more water can be seen.

>north
Ocean Waves
 You lay on your back in the warm water as the waves lift your body up and down rythmically.  The sun's relentless heat beats down on you and the salt spray stings your eyes. The sea laps against your face and sometimes over it.  When it does, you spout like a tiny human whale.

>look
Ocean Waves
 You lay on your back in the warm water as the waves lift your body up and down rythmically.  The sun's relentless heat beats down on you and the salt spray stings your eyes. The sea laps against your face and sometimes over it.  When it does, you spout like a tiny human whale.

>look at plank
You can't see any such thing.

>west
Rippling Waves
You cling to a piece of wood.  It seems to have been part of a boat at one time..

>look at wood
It's a sturdy plank of the type used to make wooden hulls. There is a small knothole in the middle of it.

>inventory
You are carrying:
  a jacket

>put on jacket
You put on the jacket.

>north
You begin to paddle in that direction but without a plan or destination you soon lose hope and return.

>west
You begin to paddle in that direction but without a plan or destination you soon lose hope and return.

>east
Ocean Waves
 You lay on your back in the warm water as the waves lift your body up and down rythmically.  The sun's relentless heat beats down on you and the salt spray stings your eyes. The sea laps against your face and sometimes over it.  When it does, you spout like a tiny human whale.

>east
Open Water
 You tread water to stay afloat.  You're getting tired. Nothing but more water can be seen.

>east
You begin to paddle in that direction but without a plan or destination you soon lose hope and return.

>west
Ocean Waves
 You lay on your back in the warm water as the waves lift your body up and down rythmically.  The sun's relentless heat beats down on you and the salt spray stings your eyes. The sea laps against your face and sometimes over it.  When it does, you spout like a tiny human whale.

>south
More Open Water
 You tread water to stay afloat.  You're getting tired.  Nothing but more water can be seen.

* * *

>north
Ocean Waves
 You lay on your back in the warm water as the waves lift your body up and down rythmically.  The sun's relentless heat beats down on you and the salt spray stings your eyes. The sea laps against your face and sometimes over it.  When it does, you spout like a tiny human whale.

>north
Floating Object
A body seems to have been the source of a partial meal.

>north
You can't go that way.

>east
You can't go that way.

>west
You can't go that way.

>south
Ocean Waves
 You lay on your back in the warm water as the waves lift your body up and down rythmically.  The sun's relentless heat beats down on you and the salt spray stings your eyes. The sea laps against your face and sometimes over it.  When it does, you spout like a tiny human whale.

>west
Rippling Waves
You cling to a piece of wood.  It seems to have been part of a boat at one time..

>west
You begin to paddle in that direction but without a plan or destination you soon lose hope and return.

>noth
That's not a verb I recognise.

>north
You begin to paddle in that direction but without a plan or destination you soon lose hope and return.

>south
You begin to paddle in that direction but without a plan or destination you soon lose hope and return.

>l
Rippling Waves
You cling to a piece of wood.  It seems to have been part of a boat at one time..

>examine hole
You can't see any such thing.

>examine wood
It's a sturdy plank of the type used to make wooden hulls. There is a small knothole in the middle of it.

>examine knothole
The knothole is empty.

>ne
You begin to paddle in that direction but without a plan or destination you soon lose hope and return.

>w
You begin to paddle in that direction but without a plan or destination you soon lose hope and return.

>e
Ocean Waves
 You lay on your back in the warm water as the waves lift your body up and down rythmically.  The sun's relentless heat beats down on you and the salt spray stings your eyes. The sea laps against your face and sometimes over it.  When it does, you spout like a tiny human whale.

>ne
Even More Open Water
A stick of very wet driftwood, about six feet long and and one inch thick.

>get wood
You can't see any such thing.

>get driftwood
You can't see any such thing.

>get stick
Taken.

>s
You begin to paddle in that direction but without a plan or destination you soon lose hope and return.

* * *

>e
You begin to paddle in that direction but without a plan or destination you soon lose hope and return.

>w
You begin to paddle in that direction but without a plan or destination you soon lose hope and return.

>look
Even More Open Water

>east
You begin to paddle in that direction but without a plan or destination you soon lose hope and return.

>s
You begin to paddle in that direction but without a plan or destination you soon lose hope and return.

>w
You begin to paddle in that direction but without a plan or destination you soon lose hope and return.

>n
You begin to paddle in that direction but without a plan or destination you soon lose hope and return.

>se
You begin to paddle in that direction but without a plan or destination you soon lose hope and return.

>ne
You begin to paddle in that direction but without a plan or destination you soon lose hope and return.

* * *

>w
You begin to paddle in that direction but without a plan or destination you soon lose hope and return.

>southeast
You begin to paddle in that direction but without a plan or destination you soon lose hope and return.

>sw
Ocean Waves
 You lay on your back in the warm water as the waves lift your body up and down rythmically.  The sun's relentless heat beats down on you and the salt spray stings your eyes. The sea laps against your face and sometimes over it.  When it does, you spout like a tiny human whale.

* * *

>w
Rippling Waves
You cling to a piece of wood.  It seems to have been part of a boat at one time..

>put stick in knothole
You place the driftwood stick into the knothole. It's tight fit but you manage it. Your little plank surfboard now has a mast.

>take off jacket
You take off the jacket.

>put jacket on stick
You drape the jacket over the stick by the collar.
The wind catches the jacket and pulls you along over the waves.

Rushing Waves (on the piece of wood)
You rush along the tops of the waves as the wind blows your makeshift sail.  The board is slippery and wet and hits the occasional wave just so, sending a spray into your face, almost knocking you from the board. You cling to the fragile looking stick of driftwood desperately hoping that it will hold and keep you on the board.

>look
Rushing Waves (on the piece of wood)
You rush along the tops of the waves as the wind blows your makeshift sail.  The board is slippery and wet and hits the occasional wave just so, sending a spray into your face, almost knocking you from the board. You cling to the fragile looking stick of driftwood desperately hoping that it will hold and keep you on the board.

>look
Rushing Waves (on the piece of wood)
You rush along the tops of the waves as the wind blows your makeshift sail.  The board is slippery and wet and hits the occasional wave just so, sending a spray into your face, almost knocking you from the board. You cling to the fragile looking stick of driftwood desperately hoping that it will hold and keep you on the board.

>west
You begin to paddle in that direction but without a plan or destination you soon lose hope and return.

The wind suddenly shifts to the westward! You speed ahead toward the island as the wind catches your fancy jacket-sail.

>west
You begin to paddle in that direction but without a plan or destination you soon lose hope and return.

The wind suddenly shifts to the westward! You speed ahead toward the island as the wind catches your fancy jacket-sail.

>west
You begin to paddle in that direction but without a plan or destination you soon lose hope and return.

The wind suddenly shifts to the southwestward! Your speed toward the island has slowed to a crawl.

>sw
You begin to paddle in that direction but without a plan or destination you soon lose hope and return.

>sw
You begin to paddle in that direction but without a plan or destination you soon lose hope and return.

The wind suddenly shifts to the northwestward! Your speed toward the island has slowed to a crawl.

>nw
You begin to paddle in that direction but without a plan or destination you soon lose hope and return.

The wind suddenly shifts to the southwestward! Your speed toward the island has slowed to a crawl.

>sw
You begin to paddle in that direction but without a plan or destination you soon lose hope and return.

>l
Journeying On The Waves (on the piece of wood)
A brisk southwestward wind is blowing. The sun hangs low in the sky over a distant island. Your speed toward the island has slowed to a crawl.

You can see a centered positioned sail here.

>sw
You begin to paddle in that direction but without a plan or destination you soon lose hope and return.

The wind suddenly shifts to the southwestward! Your speed toward the island has slowed to a crawl.

>turn sail sw
I only understood you as far as wanting to turn the centered positioned sail.

>turn the sail
Nothing obvious happens.

>turn the sail sw
I only understood you as far as wanting to turn the centered positioned sail.

>turn sail left
You twist the mast slightly to the left.

The wind suddenly shifts to the westward! Your speed toward the island has slowed to a crawl.

>turn sail right
You twist the mast slightly to the right.

>look
Journeying On The Waves (on the piece of wood)
A brisk southwestward wind is blowing. The sun hangs low in the sky over a distant island. Your speed toward the island has slowed to a crawl.

You can see a right positioned sail here.

The wind suddenly shifts to the southwestward! Your speed toward the island has slowed to a crawl.

>turn sail left
You twist the mast slightly to the left.

The wind suddenly shifts to the southwestward! Your speed toward the island has slowed to a crawl.

>look
Journeying On The Waves (on the piece of wood)
A brisk southwestward wind is blowing. The sun hangs low in the sky over a distant island. Your speed toward the island has slowed to a crawl.

You can see a centered positioned sail here.

>turn sail left
You twist the mast slightly to the left.

The wind suddenly shifts to the northwestward! Your speed toward the island has slowed to a crawl.

>look
Journeying On The Waves (on the piece of wood)
A brisk northwestward wind is blowing. The sun hangs low in the sky over a distant island. Your speed toward the island has slowed to a crawl.

You can see a left positioned sail here.

>turn sail right
You twist the mast slightly to the right.

The wind suddenly shifts to the northwestward! Your speed toward the island has slowed to a crawl.

>turn sail right
You twist the mast slightly to the right.

>look
Journeying On The Waves (on the piece of wood)
A brisk westward wind is blowing. The sun hangs low in the sky over a distant island. Your speed toward the island has slowed to a crawl.

You can see a right positioned sail here.

>turn sail left
You twist the mast slightly to the left.

The wind suddenly shifts to the westward! You speed ahead toward the island as the wind catches your fancy jacket-sail.

>look
Journeying On The Waves (on the piece of wood)
A brisk westward wind is blowing. The sun hangs low in the sky over a distant island. You speed ahead toward the island as the wind catches your fancy jacket-sail.

You can see a centered positioned sail here.

The wind suddenly shifts to the westward! You speed ahead toward the island as the wind catches your fancy jacket-sail.

>look
Journeying On The Waves (on the piece of wood)
A brisk westward wind is blowing. The sun hangs low in the sky over a distant island. You speed ahead toward the island as the wind catches your fancy jacket-sail.

You can see a centered positioned sail here.

>look
Journeying On The Waves (on the piece of wood)
A brisk westward wind is blowing. The sun hangs low in the sky over a distant island. You speed ahead toward the island as the wind catches your fancy jacket-sail.

You can see a centered positioned sail here.

The wind suddenly shifts to the westward! You speed ahead toward the island as the wind catches your fancy jacket-sail.

* * *

>look
Journeying On The Waves (on the piece of wood)
A brisk westward wind is blowing. The sun hangs low in the sky over a distant island. You speed ahead toward the island as the wind catches your fancy jacket-sail.

You can see a centered positioned sail here.

>look
Journeying On The Waves (on the piece of wood)
A brisk westward wind is blowing. The sun hangs low in the sky over a distant island. You speed ahead toward the island as the wind catches your fancy jacket-sail.

You can see a centered positioned sail here.

>look
Island Beach (on the piece of wood)
You are on a beautiful island beach.

>look
Island Beach (on the piece of wood)
You are on a beautiful island beach.

>w
You can't go that way.

>n
You can't go that way.

>e
You can't go that way.

>s
You can't go that way.

* * *

>ne
You can't go that way.

>w
You can't go that way.

>nw
You can't go that way.

>se
You can't go that way.

* * *

>look at the ocean.
The ocean is vast and wide and waves undulate over it.

>s
More Open Water
 You tread water to stay afloat.  You're getting tired.  Nothing but more water can be seen.

>examine
(the Ocean)
The ocean is vast and wide and waves undulate over it.

>e
You can't go that way.

>w
You can't go that way.

>n
Ocean Waves
 You lay on your back in the warm salt water as the waves lift your body up and down rythmically.  The sun's relentless heat beats down on you and the salt water stings your eyes. The sea water laps against your face and sometimes over it.  You sputter out a little water in a spray like a tiny human whale.

>examine
(the Ocean)
The ocean is vast and wide and waves undulate over it.

>look
Ocean Waves
 You lay on your back in the warm salt water as the waves lift your body up and down rythmically.  The sun's relentless heat beats down on you and the salt water stings your eyes. The sea water laps against your face and sometimes over it.  You sputter out a little water in a spray like a tiny human whale.

* * *

>n
Glittering Waves
....  You tread water, and you are getting exhausted.  What is left of a human body floats on the surface here.  Something has been eating it.

On the body is a jacket.

You think you must have hit your head against the ship during the fall, because a small raised lump on the back of your skull is throbbing.

What next?

>e
Even More Open Water
 You tread water to stay afloat. You're getting tired.  A stick of very wet driftwood, about six feet long and and one inch thick.

>sw
Ocean Waves
 You lay on your back in the warm water as the waves lift your body up and down rythmically.  The sun's relentless heat beats down on you and the salt spray stings your eyes. The sea laps against your face and sometimes over it.  When it does, you spout like a tiny human whale.

>ne
Even More Open Water
 You tread water to stay afloat. You're getting tired.  A stick of very wet driftwood, about six feet long and and one inch thick.

>w
Floating Object
 You tread water to stay afloat. You're getting tired.  A body seems to have been the source of a partial meal.

On the body is a jacket.

>e
Even More Open Water
 You tread water to stay afloat. You're getting tired.  A stick of very wet driftwood, about six feet long and and one inch thick.

>w
Floating Object
 You tread water to stay afloat. You're getting tired.  A body seems to have been the source of a partial meal.

On the body is a jacket.

>s
Ocean Waves
 You lay on your back in the warm water as the waves lift your body up and down rythmically.  The sun's relentless heat beats down on you and the salt spray stings your eyes. The sea laps against your face and sometimes over it.  When it does, you spout like a tiny human whale.

>e
Open Water
 You tread water to stay afloat. You're getting tired. If only you had something to float on. Nothing but more water can be seen.

* * *

>s
Ocean Waves
 You lay on your back in the warm water as the waves lift your body up and down rythmically.  The sun's relentless heat beats down on you and the salt spray stings your eyes. The sea laps against your face and sometimes over it.  When it does, you spout like a tiny human whale.

>nw
You begin to paddle in that direction but without a plan or destination you soon lose hope and return.

>w
Rippling Waves
You cling to a piece of wood.  It seems to have been part of a boat at one time..

>n
You begin to paddle in that direction but without a plan or destination you soon lose hope and return.

>s
You begin to paddle in that direction but without a plan or destination you soon lose hope and return.

* * *

>e
Ocean Waves
 You lay on your back in the warm water as the waves lift your body up and down rythmically.  The sun's relentless heat beats down on you and the salt spray stings your eyes. The sea laps against your face and sometimes over it.  When it does, you spout like a tiny human whale.

>s
More Open Water
 You tread water to stay afloat. You're getting tired.  Nothing but more water can be seen.

>s
You begin to paddle in that direction but without a plan or destination you soon lose hope and return.

>ne
Open Water
 You tread water to stay afloat. You're getting tired. If only you had something to float on. Nothing but more water can be seen.

>n
Even More Open Water
 You tread water to stay afloat. You're getting tired.  A stick of very wet driftwood, about six feet long and and one inch thick.

>e
You begin to paddle in that direction but without a plan or destination you soon lose hope and return.

>n
You begin to paddle in that direction but without a plan or destination you soon lose hope and return.

>sw
Ocean Waves
 You lay on your back in the warm water as the waves lift your body up and down rythmically.  The sun's relentless heat beats down on you and the salt spray stings your eyes. The sea laps against your face and sometimes over it.  When it does, you spout like a tiny human whale.

>s
More Open Water
 You tread water to stay afloat. You're getting tired.  Nothing but more water can be seen.

>e
You begin to paddle in that direction but without a plan or destination you soon lose hope and return.

>ne
Open Water
 You tread water to stay afloat. You're getting tired. If only you had something to float on. Nothing but more water can be seen.

* * *

>s
Ocean Waves
 You lay on your back in the warm water as the waves lift your body up and down rythmically.  The sun's relentless heat beats down on you and the salt spray stings your eyes. The sea laps against your face and sometimes over it.  When it does, you spout like a tiny human whale.

>w
Rippling Waves
You cling to a piece of wood.  It seems to have been part of a boat at one time..

* * *

>e
Even More Open Water
 You tread water to stay afloat. You're getting tired.  A stick of very wet driftwood, about six feet long and and one inch thick.

>w
Piece of Debri

>l
Piece of Debri

>n
You can't go that way.

* * *

>s
You can't go that way.

>e
Open Water

>l
Open Water

>i
You are carrying nothing.

>look
Open Water

>e
You can't go that way.

* * *

>s
You can't go that way.

>w
Piece of Debri

>e
Open Water

>n
Small Floating Object

>l
Small Floating Object

>s
More Open Water

>n
Small Floating Object

>s
More Open Water

>e
You can't go that way.

* * *

>w
You can't go that way.

>n
Small Floating Object

>n
You can't go that way.

* * *

>w
You can't go that way.

>w
You can't go that way.

>e
You can't go that way.

>s
More Open Water

>s
You can't go that way.

* * *

>n
You can't go that way.

>s
More Open Water

* * *

>e
You can't go that way.

>n
Small Floating Object

>w
You can't go that way.

* * *

>n
Small Floating Object

>e
You can't go that way.

* * *

>n
Glittering Waves
....  You tread water, and you are getting exhausted.  What is left of a human body floats on the surface here.  Something has been eating it.

On the body is a jacket.

You think you must have hit your head against the ship during the fall, because a small raised lump on the back of your skull is throbbing.

What next?

>examine  jacket
It's an olive-drav green military fatigue jacket.

* * *

>n
Glittering Waves
....  You tread water, and you are getting exhausted.  What is left of a human body floats on the surface here.  Something has been eating it.

On the body is a jacket.

You think you must have hit your head against the ship during the fall, because a small raised lump on the back of your skull is throbbing.

What next?

>examine body
The body floats face down.  Something has taken  chunk out of its side.

On the body is a jacket.

>get body
Taken.

>s
Ocean Waves
You lay on your back in the warm salt water as the waves lift your body up and down rythmically.   The sea water laps against your face and sometimes over it.  You sputter out a little water in a spray like a tiny human whale.

>e
Open Water
You tread water.  Nothing but more water can be seen.

>s
You can't go that way.

>w
Ocean Waves
You lay on your back in the warm salt water as the waves lift your body up and down rythmically.   The sea water laps against your face and sometimes over it.  You sputter out a little water in a spray like a tiny human whale.

>w
Piece Of Debri
You cling to the piece of wood.  It seems to have been part of a boat at one time.

>l
Piece Of Debri
You cling to the piece of wood.  It seems to have been part of a boat at one time.

* * *

>n
Glittering Waves
....  You tread water, and you are getting exhausted.  What is left of a human body floats on the surface here.  Something has been eating it.

On the body is a jacket.

You think you must have hit your head against the ship during the fall, because a small raised lump on the back of your skull is throbbing.

What next?

>examine jacket
It's an olive-drav green military fatigue jacket with oversized pockets.

>examine pocket
You see nothing special about pocket.

>open pocket
You open pocket, revealing a knife.

* * *

>examine jacket
It's an olive-drav green military fatigue jacket with oversized pockets.

>examine pockets
In pocket is a knife.

>examine pocket
In pocket is a knife.

>get knife
You can't hold the knife and swim.

I beg your pardon?

>e
You can't go that way.

>s
Ocean Waves
 You lay on your back in the warm water as the waves lift your body up and down rythmically.  The sun's relentless heat beats down on you and the salt spray stings your eyes. The sea laps against your face and sometimes over it.  When it does, you spout like a tiny human whale.

>ne
Even More Open Water
 You tread water to stay afloat. You're getting tired.  A stick of very wet driftwood, about six feet long and and one inch thick.

>w
You begin to paddle in that direction but without a plan or destination you soon lose hope and return.

* * *

>sw
Ocean Waves
 You lay on your back in the warm water as the waves lift your body up and down rythmically.  The sun's relentless heat beats down on you and the salt spray stings your eyes. The sea laps against your face and sometimes over it.  When it does, you spout like a tiny human whale.

>n
Floating Object
 You tread water to stay afloat. You're getting tired.  A body seems to have been the source of a partial meal.

On the body is a jacket.

* * *

>examine pockets
In pocket is a knife.

>get knife
Taken.

>get jacket
Taken.

>s
Ocean Waves
You lay on your back in the warm salt water as the waves lift your body up and down rythmically.   The sea water laps against your face and sometimes over it.  You sputter out a little water in a spray like a tiny human whale.

>w
Piece Of Debri
You cling to the piece of wood.  It seems to have been part of a boat at one time.

* * *

>l
Piece Of Debri
You cling to the piece of wood.  It seems to have been part of a boat at one time.

>get on wood
You mount the piece of wood.

>e
Ocean Waves (on the piece of wood)
You lay on your back in the warm salt water as the waves lift your body up and down rythmically.   The sea water laps against your face and sometimes over it.  You sputter out a little water in a spray like a tiny human whale.

>e
Open Water (on the piece of wood)
Nothing but more water can be seen.

>w
Ocean Waves (on the piece of wood)
You lay on your back in the warm salt water as the waves lift your body up and down rythmically.   The sea water laps against your face and sometimes over it.  You sputter out a little water in a spray like a tiny human whale.

>s
More Open Water (on the piece of wood)
Nothing but more water can be seen.

>n
Ocean Waves (on the piece of wood)
You lay on your back in the warm salt water as the waves lift your body up and down rythmically.   The sea water laps against your face and sometimes over it.  You sputter out a little water in a spray like a tiny human whale.

>n
Small Floating Object (on the piece of wood)
A body seems to have been the source of a partial meal.

* * *

>examine jacket
It's an olive-drav green military fatigue jacket with oversized pockets.

>search jacket
There is nothing on the jacket.

>l
Small Floating Object
A body seems to have been the source of a partial meal.

On the body is a jacket.

>get jacket
Taken.

>examine jacket
You see nothing special about the jacket.

>wear jacket
You put on the jacket.

>examine pocket
You see nothing special about the pocket.

* * *

>n
Glittering Waves
....  You tread water, and you are getting exhausted.  What is left of a human body floats on the surface here.  Something has been eating it.

On the body is a jacket.

You think you must have hit your head against the ship during the fall, because a small raised lump on the back of your skull is throbbing.

What next?

>examine pocket
You see nothing special about the pocket.

>open pocket
You open the pocket, revealing a knife.

>l
Small Floating Object
You see an human shape floating face down in the water.

The body seems to have been the source of a partial meal.

On the body is a jacket (on which is a pocket (in which is a knife)).

>get knife
Taken.

>get pocket
Taken.

* * *

>n
Glittering Waves
....  You tread water, and you are getting exhausted.  What is left of a human body floats on the surface here.  Something has been eating it.

On the body is a jacket.

You think you must have hit your head against the ship during the fall, because a small raised lump on the back of your skull is throbbing.

What next?

>get jacket
You can't hold the jacket and swim. You can barely stay above water as it is.

>get pocket
That's fixed in place.

>get knife
You can't see any such thing.

>open pocket
You open the pocket, revealing a knife.

>get knife
Taken.

>ls
That's not a verb I recognise.

>l
Small Floating Object
You see an human shape floating face down in the water.

The body seems to have been the source of a partial meal.

On the body is a jacket (on which is a pocket (empty)).

* * *

>get jacket
You can't hold the jacket and swim. You can barely stay above water as it is.

>s
Ocean Waves
 You lay on your back in the warm water as the waves lift your body up and down rythmically.

>e
Open Water
 You tread water to stay afloat.  You're getting tired. Nothing but more water can be seen.

The wind suddenly shifts to the westward

>w
Ocean Waves
 You lay on your back in the warm water as the waves lift your body up and down rythmically.  The sun's relentless heat beats down on you and the salt spray stings your eyes. The sea laps against your face and sometimes over it.  When it does, you spout like a tiny human whale.

>w
Rippling Waves
You cling to a piece of wood.  It seems to have been part of a boat at one time..

* * *

>e
Ocean Waves (on the piece of wood)
 The water laps at the plank you sit on, rocking you up and down.

>ne
Even More Open Water (on the piece of wood)
A stick of very wet driftwood, about six feet long and and one inch thick.

The wind suddenly shifts to the southwestward

>get stick
Taken.

>put stick in knothole
You place the driftwood stick into the knothole. It's tight fit but you manage it. Your little plank surfboard now has a mast.

* * *

>l
Rushing Waves (on the piece of wood)
You rush along the tops of the waves as the wind blows your makeshift sail.  The board is slippery and wet and hits the occasional wave just so, sending a spray into your face, almost knocking you from the board. You cling to the fragile looking stick of driftwood desperately hoping that it will hold and keep you on the board.

>l
Journeying On The Waves (on the piece of wood)
A brisk northwestward wind is blowing. The sun hangs low in the sky over a distant island. Your speed toward the island has slowed to a crawl.

You can see a centered positioned sail here.

>l
Journeying On The Waves (on the piece of wood)
A brisk northwestward wind is blowing. The sun hangs low in the sky over a distant island. Your speed toward the island has slowed to a crawl.

You can see a centered positioned sail here.

>turn sail right
You twist the mast slightly to the right.

The wind suddenly shifts to the northwestward

>l
Journeying On The Waves (on the piece of wood)
A brisk northwestward wind is blowing. The sun hangs low in the sky over a distant island. You speed ahead toward the island as the wind catches your fancy jacket-sail.

You can see a right positioned sail here.

The wind suddenly shifts to the westward

>turn sail left
You twist the mast slightly to the left.

The wind suddenly shifts to the southwestward

>l
Journeying On The Waves (on the piece of wood)
A brisk southwestward wind is blowing. The sun hangs low in the sky over a distant island. Your speed toward the island has slowed to a crawl.

You can see a centered positioned sail here.

>turn sail left
You twist the mast slightly to the left.

The wind suddenly shifts to the northwestward

>l
Journeying On The Waves (on the piece of wood)
A brisk northwestward wind is blowing. The sun hangs low in the sky over a distant island. Your speed toward the island has slowed to a crawl.

You can see a left positioned sail here.

>turn sail left
You twist the mast slightly to the left.

>l
Journeying On The Waves (on the piece of wood)
A brisk northwestward wind is blowing. The sun hangs low in the sky over a distant island. Your speed toward the island has slowed to a crawl.

You can see a left positioned sail here.

>turn sail left
You twist the mast slightly to the left.

The wind suddenly shifts to the northwestward

* * *

>l
Journeying On The Waves (on the piece of wood)
A brisk northwestward wind is blowing. The sun hangs low in the sky over a distant island. Your speed toward the island has slowed to a crawl.

You can see a left positioned sail here.

>turn sail right
You twist the mast slightly to the right.

>l
Journeying On The Waves (on the piece of wood)
A brisk southwestward wind is blowing. The sun hangs low in the sky over a distant island. Your speed toward the island has slowed to a crawl.

You can see a centered positioned sail here.

>turn sail left
You twist the mast slightly to the left.

>l
Journeying On The Waves (on the piece of wood)
A brisk southwestward wind is blowing. The sun hangs low in the sky over a distant island. You speed ahead toward the island as the wind catches your fancy jacket-sail.

You can see a left positioned sail here.

The wind suddenly shifts to the southwestward

>turn sail left
You twist the mast slightly to the left.

The wind suddenly shifts to the southwestward

>l
Journeying On The Waves (on the piece of wood)
A brisk southwestward wind is blowing. The sun hangs low in the sky over a distant island. You speed ahead toward the island as the wind catches your fancy jacket-sail.

You can see a left positioned sail here.

>turn sail left
You twist the mast slightly to the left.

* * *

>l
Journeying On The Waves (on the piece of wood)
A brisk southwestward wind is blowing. The sun hangs low in the sky over a distant island. You speed ahead toward the island as the wind catches your fancy jacket-sail.

You can see a left positioned sail here.

>restart
Are you sure you want to restart?

>y
You're in the middle of a tropical ocean on an alien world.

Alien Shores
An Interactive Fiction by Keith B Phillips
Release 1 / Serial number 160720 / Inform 7 build 6M62 (I6/v6.33 lib 6/12N) SD

Ocean Waves
 You lay on your back in the warm water as the waves lift your body up and down rythmically.  The sun's relentless heat beats down on you and the salt spray stings your eyes. The sea laps against your face and sometimes over it.  When it does, you spout like a tiny human whale.

>w
Rippling Waves
You cling to a piece of wood.  It seems to have been part of a boat at one time..

* * *

>get on wood
You mount the piece of wood.

>e
Ocean Waves (on the piece of wood)
 The water laps at the plank you sit on, rocking you up and down.

The wind suddenly shifts to the westward

>n
Floating Object (on the piece of wood)
A body seems to have been the source of a partial meal.

On the body is a jacket.

* * *

>get jacket
Taken.

>s
Ocean Waves (on the piece of wood)
 The water laps at the plank you sit on, rocking you up and down.

The wind suddenly shifts to the westward

>ne
Even More Open Water (on the piece of wood)
A stick of very wet driftwood, about six feet long and and one inch thick.

>get stick
Taken.

The wind suddenly shifts to the westward

>put stick in knothole
You place the driftwood stick into the knothole. It's tight fit but you manage it. Your little plank surfboard now has a mast.

* * *

>l
Journeying On The Waves (on the piece of wood)
A brisk northwestward wind is blowing. The sun hangs low in the sky over a distant island. Your speed toward the island has slowed to a crawl.

You can see a centered positioned sail here.

>turn sail left
You twist the mast slightly to the left.

>l
Journeying On The Waves (on the piece of wood)
A brisk northwestward wind is blowing. The sun hangs low in the sky over a distant island. Your speed toward the island has slowed to a crawl.

You can see a left positioned sail here.

The wind suddenly shifts to the northwestward

>turn sail right
You twist the mast slightly to the right.

>l
Journeying On The Waves (on the piece of wood)
A brisk westward wind is blowing. The sun hangs low in the sky over a distant island. You speed ahead toward the island as the wind catches your fancy jacket-sail.

You can see a centered positioned sail here.

>turn sail right
You twist the mast slightly to the right.

>l
Journeying On The Waves (on the piece of wood)
A brisk westward wind is blowing. The sun hangs low in the sky over a distant island. Your speed toward the island has slowed to a crawl.

You can see a right positioned sail here.

>turn sail right
You twist the mast slightly to the right.

* * *

>l
Journeying On The Waves (on the piece of wood)
A brisk westward wind is blowing. The sun hangs low in the sky over a distant island. Your speed toward the island has slowed to a crawl.

You can see a right positioned sail here.

>turn sail left
You twist the mast slightly to the left.

>l
Journeying On The Waves (on the piece of wood)
A brisk westward wind is blowing. The sun hangs low in the sky over a distant island. You speed ahead toward the island as the wind catches your fancy jacket-sail.

You can see a centered positioned sail here.

The wind suddenly shifts to the westward

>turn sail left
You twist the mast slightly to the left.

* * *

>l
Journeying On The Waves (on the piece of wood)
A brisk northwestward wind is blowing. The sun hangs low in the sky over a distant island. Your speed toward the island has slowed to a crawl.

You can see a left positioned sail here.

The wind suddenly shifts to the northwestward

>turn sail left
You twist the mast slightly to the left.

The wind suddenly shifts to the northwestward

* * *

>turn sail right
You twist the mast slightly to the right.

>l
Journeying On The Waves (on the piece of wood)
A brisk southwestward wind is blowing. The sun hangs low in the sky over a distant island. Your speed toward the island has slowed to a crawl.

You can see a centered positioned sail here.

The wind suddenly shifts to the southwestward

>turn sail left
You twist the mast slightly to the left.

The wind suddenly shifts to the northwestward

* * *

>l
Journeying On The Waves (on the piece of wood)
A brisk northwestward wind is blowing. The sun hangs low in the sky over a distant island. Your speed toward the island has slowed to a crawl.

You can see a left positioned sail here.

>turn sail left
You twist the mast slightly to the left.

The wind suddenly shifts to the westward

>l
Journeying On The Waves (on the piece of wood)
A brisk westward wind is blowing. The sun hangs low in the sky over a distant island. Your speed toward the island has slowed to a crawl.

You can see a left positioned sail here.

>l
Journeying On The Waves (on the piece of wood)
A brisk southwestward wind is blowing. The sun hangs low in the sky over a distant island. You speed ahead toward the island as the wind catches your fancy jacket-sail.

You can see a left positioned sail here.

>l
Journeying On The Waves (on the piece of wood)
A brisk southwestward wind is blowing. The sun hangs low in the sky over a distant island. You speed ahead toward the island as the wind catches your fancy jacket-sail.

You can see a left positioned sail here.

>l
Journeying On The Waves (on the piece of wood)
A brisk southwestward wind is blowing. The sun hangs low in the sky over a distant island. You speed ahead toward the island as the wind catches your fancy jacket-sail.

You can see a left positioned sail here.

The wind suddenly shifts to the southwestward

>l
Journeying On The Waves (on the piece of wood)
A brisk southwestward wind is blowing. The sun hangs low in the sky over a distant island. You speed ahead toward the island as the wind catches your fancy jacket-sail.

You can see a left positioned sail here.

The wind suddenly shifts to the southwestward

>turn sail left
You twist the mast slightly to the left.

>l
Journeying On The Waves (on the piece of wood)
A brisk westward wind is blowing. The sun hangs low in the sky over a distant island. Your speed toward the island has slowed to a crawl.

You can see a left positioned sail here.

The wind suddenly shifts to the westward

>turn sail right
You twist the mast slightly to the right.

>l
Journeying On The Waves (on the piece of wood)
A brisk northwestward wind is blowing. The sun hangs low in the sky over a distant island. Your speed toward the island has slowed to a crawl.

You can see a centered positioned sail here.

>turn sail right
You twist the mast slightly to the right.

>l
Journeying On The Waves (on the piece of wood)
A brisk northwestward wind is blowing. The sun hangs low in the sky over a distant island. You speed ahead toward the island as the wind catches your fancy jacket-sail.

You can see a right positioned sail here.

>turn sail left
You twist the mast slightly to the left.

>l
Journeying On The Waves (on the piece of wood)
A brisk northwestward wind is blowing. The sun hangs low in the sky over a distant island. Your speed toward the island has slowed to a crawl.

You can see a centered positioned sail here.

>turn sail left
You twist the mast slightly to the left.

The wind suddenly shifts to the northwestward

* * *

>turn sail left
You twist the mast slightly to the left.

>turn sail left
You twist the mast slightly to the left.

The wind suddenly shifts to the northwestward

* * *

>l
Journeying On The Waves (on the piece of wood)
A brisk southwestward wind is blowing. The sun hangs low in the sky over a distant island. Your speed toward the island has slowed to a crawl.

You can see a centered positioned sail here.

The wind suddenly shifts to the southwestward

>turn sail right
You twist the mast slightly to the right.

* * *

>l
Journeying On The Waves (on the piece of wood)
A brisk westward wind is blowing. The sun hangs low in the sky over a distant island. Your speed toward the island has slowed to a crawl.

You can see a right positioned sail here.

>turn sail left
You twist the mast slightly to the left.

The wind suddenly shifts to the westward

>l
Journeying On The Waves (on the piece of wood)
A brisk westward wind is blowing. The sun hangs low in the sky over a distant island. You speed ahead toward the island as the wind catches your fancy jacket-sail.

You can see a centered positioned sail here.

The wind suddenly shifts to the northwestward

>turn sail right
You twist the mast slightly to the right.

>l
Journeying On The Waves (on the piece of wood)
A brisk northwestward wind is blowing. The sun hangs low in the sky over a distant island. You speed ahead toward the island as the wind catches your fancy jacket-sail.

You can see a right positioned sail here.

The wind suddenly shifts to the northwestward

>turn sail left
You twist the mast slightly to the left.

* * *

>l
Journeying On The Waves (on the piece of wood)
A brisk northwestward wind is blowing. The sun hangs low in the sky over a distant island. You speed ahead toward the island as the wind catches your fancy jacket-sail.

You can see a right positioned sail here.

The wind suddenly shifts to the northwestward

>l
Journeying On The Waves (on the piece of wood)
A brisk northwestward wind is blowing. The sun hangs low in the sky over a distant island. You speed ahead toward the island as the wind catches your fancy jacket-sail.

You can see a right positioned sail here.

* * *

>turn sail right
You twist the mast slightly to the right.

>l
Journeying On The Waves (on the piece of wood)
A brisk northwestward wind is blowing. The sun hangs low in the sky over a distant island. Your speed toward the island has slowed to a crawl.

You can see a centered positioned sail here.

The wind suddenly shifts to the northwestward

>turn sail right
You twist the mast slightly to the right.

* * *

>l
Journeying On The Waves (on the piece of wood)
A brisk northwestward wind is blowing. The sun hangs low in the sky over a distant island. You speed ahead toward the island as the wind catches your fancy jacket-sail.

You can see a right positioned sail here.

>turn sail left
You twist the mast slightly to the left.

The wind suddenly shifts to the northwestward

>l
Journeying On The Waves (on the piece of wood)
A brisk northwestward wind is blowing. The sun hangs low in the sky over a distant island. Your speed toward the island has slowed to a crawl.

You can see a centered positioned sail here.

The wind suddenly shifts to the westward

>l
Journeying On The Waves (on the piece of wood)
A brisk westward wind is blowing. The sun hangs low in the sky over a distant island. You speed ahead toward the island as the wind catches your fancy jacket-sail.

You can see a centered positioned sail here.

>turn sail left
You twist the mast slightly to the left.

The wind suddenly shifts to the southwestward

>l
Journeying On The Waves (on the piece of wood)
A brisk southwestward wind is blowing. The sun hangs low in the sky over a distant island. You speed ahead toward the island as the wind catches your fancy jacket-sail.

You can see a left positioned sail here.

The wind suddenly shifts to the westward

>turn sail left
You twist the mast slightly to the left.

The wind suddenly shifts to the westward

* * *

>l
Journeying On The Waves (on the piece of wood)
A brisk westward wind is blowing. The sun hangs low in the sky over a distant island. Your speed toward the island has slowed to a crawl.

You can see a left positioned sail here.

>turn sail right
You twist the mast slightly to the right.

* * *

>turn sail left
You twist the mast slightly to the left.

>l
Journeying On The Waves (on the piece of wood)
A brisk southwestward wind is blowing. The sun hangs low in the sky over a distant island. Your speed toward the island has slowed to a crawl.

You can see a centered positioned sail here.

The wind suddenly shifts to the southwestward

>turn sail left
You twist the mast slightly to the left.

* * *

>l
Journeying On The Waves (on the piece of wood)
A brisk southwestward wind is blowing. The sun hangs low in the sky over a distant island. You speed ahead toward the island as the wind catches your fancy jacket-sail.

You can see a left positioned sail here.

>turn sail right
You twist the mast slightly to the right.

* * *

>l
Journeying On The Waves (on the piece of wood)
A brisk southwestward wind is blowing. The sun hangs low in the sky over a distant island. Your speed toward the island has slowed to a crawl.

You can see a centered positioned sail here.

>turn sail right
You twist the mast slightly to the right.

The wind suddenly shifts to the southwestward

>l
Journeying On The Waves (on the piece of wood)
A brisk southwestward wind is blowing. The sun hangs low in the sky over a distant island. Your speed toward the island has slowed to a crawl.

You can see a right positioned sail here.

* * *

>s
Ocean Waves
 You lay on your back in the warm water as the waves lift your body up and down rythmically.

>ne
Even More Open Water
A stick of very wet driftwood, about six feet long and and one inch thick.

* * *

>get stick
Taken.

>put stick in knothole
You can't see any such thing.

>w
You begin to paddle in that direction but without a plan or destination you soon lose hope and return.

* * *

>get on wood
You mount the piece of wood.

>put stick in knothole
You place the driftwood stick into the knothole. It's tight fit but you manage it. Your little plank surfboard now has a mast.

* * *

>l
Rushing Waves (on the piece of wood)
You rush along the tops of the waves as the wind blows your makeshift sail.  The board is slippery and wet and hits the occasional wave just so, sending a spray into your face, almost knocking you from the board. You cling to the fragile looking stick of driftwood desperately hoping that it will hold and keep you on the board.

>l
Journing On The Waves (on the piece of wood)
You continue to be totally swept along westward toward the sun that hangs over the sea in the sky.  You begin to see something peeking above the horizon of waves in the distance.

>turn mast
You can't see any such thing.

>examine mast
You can't see any such thing.

>examine mast position
You can't see any such thing.

>examine the position of the mast.
You can't see any such thing.

>center the mast.
That's not a verb I recognise.

>burn sail
You can't see any such thing.

>burn mast
You can't see any such thing.

>burn wood
This dangerous act would achieve little.

>burn mast with wood
You can't see any such thing.

>burn mast with jacket
You can't see any such thing.

>i
You are carrying nothing.

>l
Journing On The Waves (on the piece of wood)
You continue to be totally swept along westward toward the sun that hangs over the sea in the sky.  You begin to see something peeking above the horizon of waves in the distance.

>restart
Are you sure you want to restart?

>y
You're in the middle of a tropical ocean on an alien world.

Alien Shores
An Interactive Fiction by Keith B Phillips
Release 1 / Serial number 160718 / Inform 7 build 6M62 (I6/v6.33 lib 6/12N) SD

Ocean Waves
 You lay on your back in the warm water as the waves lift your body up and down rythmically.  The sun's relentless heat beats down on you and the salt spray stings your eyes. The sea laps against your face and sometimes over it.  When it does, you spout like a tiny human whale.

>w
Rippling Waves
You cling to a piece of wood.  It seems to have been part of a boat at one time..

>e
Ocean Waves
 You lay on your back in the warm water as the waves lift your body up and down rythmically.  The sun's relentless heat beats down on you and the salt spray stings your eyes. The sea laps against your face and sometimes over it.  When it does, you spout like a tiny human whale.

>s
More Open Water
 You tread water to stay afloat.  You're getting tired.  Nothing but more water can be seen.

* * *

>n
Ocean Waves
 You lay on your back in the warm water as the waves lift your body up and down rythmically.  The sun's relentless heat beats down on you and the salt spray stings your eyes. The sea laps against your face and sometimes over it.  When it does, you spout like a tiny human whale.

>n
Floating Object
A body seems to have been the source of a partial meal.

On the body is a jacket.

>get jacket
Taken.

>s
Ocean Waves
 You lay on your back in the warm water as the waves lift your body up and down rythmically.  The sun's relentless heat beats down on you and the salt spray stings your eyes. The sea laps against your face and sometimes over it.  When it does, you spout like a tiny human whale.

* * *

>w
Rippling Waves
You cling to a piece of wood.  It seems to have been part of a boat at one time..

>burn jacket with wood
I only understood you as far as wanting to burn the jacket.

>turn mast with wood
You can't see any such thing.

>l
Rippling Waves
You cling to a piece of wood.  It seems to have been part of a boat at one time..

>turn wood with jacket
Your choice of lighter isn't important in this story: BURN SOMETHING will suffice.

* * *

>get on wood
You mount the piece of wood.

>put jacket on stick
You drape the jacket over the stick by the collar.

I beg your pardon?

>put stick in knothole
You place the driftwood stick into the knothole. It's tight fit but you manage it. Your little plank surfboard now has a mast.
The wind catches the jacket and pulls you along over the waves.

White Caps
You rush along the tops of the white caps as the wind blows your makeshift sail.  The board is slippery and wet and hits the occasional wave just so sending a spray into almost knocking you from the board.  You cling to the fragile looking stick of driftwood desperately hoping that it will hold and keep you on the board.

* * *

>put jacket on stick
You drape the jacket over the stick by the collar.

>put stick in knothole
You place the driftwood stick into the knothole. It's tight fit but you manage it. Your little plank surfboard now has a mast.
The wind catches the jacket and pulls you along over the waves.

White Caps
You rush along the tops of the white caps as the wind blows your makeshift sail.  The board is slippery and wet and hits the occasional wave just so, sending a spray into your face, almost knocking you from the board. You cling to the fragile looking stick of driftwood desperately hoping that it will hold and keep you on the board.

* * *

>l
Rushing Waves (on the piece of wood)
You rush along the tops of the waves as the wind blows your makeshift sail.  The board is slippery and wet and hits the occasional wave just so, sending a spray into your face, almost knocking you from the board. You cling to the fragile looking stick of driftwood desperately hoping that it will hold and keep you on the board.

>l
Journing On The Waves (on the piece of wood)
You continue to be totally swept along westward toward the sun that hangs over the sea in the sky.  You begin to see something peeking above the horizon of waves in the distance.

You can see a sail here.

>examine sail
You see nothing special about the sail.

>look at sail
You see nothing special about the sail.

>turn sail
center

>turn sail
center

* * *

>w
Rippling Waves
You cling to a piece of wood.  It seems to have been part of a boat at one time..

>get wood
That's fixed in place.

>get on wood
You mount the piece of wood.

* * *

>put stick in knothole
You place the driftwood stick into the knothole. It's tight fit but you manage it. Your little plank surfboard now has a mast.

>l
Rippling Waves (on the piece of wood)

>put jacket on stick
You put the jacket on the stick.

>l
Rippling Waves (on the piece of wood)

>i
You are carrying nothing.

>get jacket
Taken.

>actions
Actions listing on.

>put jacket on stick
[putting the jacket on the stick]
You put the jacket on the stick.
[putting the jacket on the stick - succeeded]

* * *

>s
Ocean Waves
 You lay on your back in the warm water as the waves lift your body up and down rythmically.

>w
Rippling Waves
 You see a piece of wood about six feet in length. You swim over and cling to it gratefully. You look at the wood, and a chill goes through you. This is actually a board that has been roughly hewn from log.

You can see a piece of wood here.

>examine wood
You see nothing special about the piece of wood.

* * *

>w
Rippling Waves
 You see a piece of wood about six feet in length. You swim over and cling to it gratefully. You look at the wood, and a chill goes through you. This is actually a board that has been roughly hewn from log.

You can see a piece of wood here.

>get on wood
Thank goodness!  You were getting exhausted just trying to stay alfloat.

You mount the piece of wood.

>e
Ocean Waves (on the piece of wood)
 The water laps at the plank you sit on, rocking you up and down.

>ne
Even More Open Water (on the piece of wood)
A piece of very wet driftwood, about six feet long and and one inch thick.

>get stick
Taken.

>put stick in knothole
You put the stick into the knothole.

>put jacket on stick
You put the jacket on the stick.

The wind catches the jacket and pulls you along over the waves.

* * *

>get on wood
Thank goodness!  You were getting exhausted just trying to stay alfloat.

You mount the piece of wood.

>put stick on wood
You can't see any such thing.

>e
Ocean Waves (on the piece of wood)
 The water laps at the plank you sit on, rocking you up and down.

>ne
Even More Open Water (on the piece of wood)
You can see a stick here.

>get stick
Taken.

>put stick on wood
Dropped.

>put jacket on stick
You put the jacket on the stick.

* * *

>w
Rippling Waves
 You see a piece of wood about six feet in length. You swim over and cling to it gratefully. You look at the wood, and a chill goes through you. This is actually a board that has been roughly hewn from log.

You can see a piece of wood here.

>get wood
That's fixed in place.

* * *

>get stick
Taken.

>i
You are carrying:
  a stick
  a jacket

>put jacket on stick
You put the jacket on the stick.

>get jacket
Taken.

* * *

I beg your pardon?

>l
Even More Open Water (on the piece of wood)

>i
You are carrying:
  a jacket

>put jacket on stick
You put the jacket on the stick.

>i
You are carrying nothing.

>l
Even More Open Water (on the piece of wood)

* * *

>put jacket on stick
You put the jacket on the stick.

>put stick in knothole
(first taking the stick)
The wind catches the jacket and pulls you along over the waves.

White Caps
You rush along the tops of the white caps as the wind blows your makeshift sail.  The board is slippery and wet and hits the occasional wave just so sending a spray into almost knocking you from the board.  You cling to the fragile looking stick of driftwood desperately hoping that it will hold and keep you on the board.

* * *

>get jacket
You can't hold the jacket and swim. You can barely stay above water as it is.

>w
You can't go that way.

>s
Ocean Waves
 You lay on your back in the warm water as the waves lift your body up and down rythmically.

>w
Rippling Waves
 You see a piece of wood about six feet in length. You swim over and cling to it gratefully. You look at the wood, and a surge of hope goes through you. This is actually a board that has been roughly hewn from log.

You can see a piece of wood here.

>get on wood
You mount the piece of wood.

* * *

>e
Ocean Waves (on the piece of wood)
 The water laps at the plank you sit on, rocking you up and down.

>ne
Even More Open Water (on the piece of wood)
A stick of very wet driftwood, about six feet long and and one inch thick.

The wind suddenly shifts to the southwestward! Your speed toward the island has slowed to a crawl.

>get stick
Taken.

* * *

>l
Rushing Waves (on the piece of wood)
You rush along the tops of the waves as the wind blows your makeshift sail.  The board is slippery and wet and hits the occasional wave just so, sending a spray into your face, almost knocking you from the board. You cling to the fragile looking stick of driftwood desperately hoping that it will hold and keep you on the board.

>l
Rushing Waves (on the piece of wood)
You rush along the tops of the waves as the wind blows your makeshift sail.  The board is slippery and wet and hits the occasional wave just so, sending a spray into your face, almost knocking you from the board. You cling to the fragile looking stick of driftwood desperately hoping that it will hold and keep you on the board.

The wind suddenly shifts to the westward! You speed ahead toward the island as the wind catches your fancy jacket-sail.

>l
Rushing Waves (on the piece of wood)
You rush along the tops of the waves as the wind blows your makeshift sail.  The board is slippery and wet and hits the occasional wave just so, sending a spray into your face, almost knocking you from the board. You cling to the fragile looking stick of driftwood desperately hoping that it will hold and keep you on the board.

>l
Journeying On The Waves (on the piece of wood)
A brisk southwestward wind is blowing. The sun hangs low in the sky over a distant island. Your speed toward the island has slowed to a crawl.

You can see a centered positioned sail here.

>l
Journeying On The Waves (on the piece of wood)
A brisk southwestward wind is blowing. The sun hangs low in the sky over a distant island. Your speed toward the island has slowed to a crawl.

You can see a centered positioned sail here.

The wind suddenly shifts to the southwestward! Your speed toward the island has slowed to a crawl.

>turn sail left
You twist the mast slightly to the left.

The wind suddenly shifts to the southwestward! You speed ahead toward the island as the wind catches your fancy jacket-sail.

>l
Journeying On The Waves (on the piece of wood)
A brisk southwestward wind is blowing. The sun hangs low in the sky over a distant island. You speed ahead toward the island as the wind catches your fancy jacket-sail.

You can see a left positioned sail here.

The wind suddenly shifts to the westward! Your speed toward the island has slowed to a crawl.

>l
Journeying On The Waves (on the piece of wood)
A brisk westward wind is blowing. The sun hangs low in the sky over a distant island. Your speed toward the island has slowed to a crawl.

You can see a left positioned sail here.

>l
Journeying On The Waves (on the piece of wood)
A brisk westward wind is blowing. The sun hangs low in the sky over a distant island. Your speed toward the island has slowed to a crawl.

You can see a left positioned sail here.

* * *

>l
Journeying On The Waves (on the piece of wood)
A brisk westward wind is blowing. The sun hangs low in the sky over a distant island. You speed ahead toward the island as the wind catches your fancy jacket-sail.

You can see a centered positioned sail here.

>l
Journeying On The Waves (on the piece of wood)
A brisk westward wind is blowing. The sun hangs low in the sky over a distant island. You speed ahead toward the island as the wind catches your fancy jacket-sail.

You can see a centered positioned sail here.

>l
Journeying On The Waves (on the piece of wood)
A brisk northwestward wind is blowing. The sun hangs low in the sky over a distant island. Your speed toward the island has slowed to a crawl.

You can see a centered positioned sail here.

>l
Journeying On The Waves (on the piece of wood)
A brisk northwestward wind is blowing. The sun hangs low in the sky over a distant island. Your speed toward the island has slowed to a crawl.

You can see a centered positioned sail here.

The wind suddenly shifts to the northwestward! Your speed toward the island has slowed to a crawl.

>turn sail left
You twist the mast slightly to the left.

The wind suddenly shifts to the westward! Your speed toward the island has slowed to a crawl.

>l
Journeying On The Waves (on the piece of wood)
A brisk westward wind is blowing. The sun hangs low in the sky over a distant island. Your speed toward the island has slowed to a crawl.

You can see a left positioned sail here.

>turn right
You can't see any such thing.

I beg your pardon?

>turn sail right
You twist the mast slightly to the right.

* * *

>l
Journeying On The Waves (on the piece of wood)
A brisk northwestward wind is blowing. The sun hangs low in the sky over a distant island. Your speed toward the island has slowed to a crawl.

You can see a centered positioned sail here.

The wind suddenly shifts to the northwestward! Your speed toward the island has slowed to a crawl.

>l
Journeying On The Waves (on the piece of wood)
A brisk northwestward wind is blowing. The sun hangs low in the sky over a distant island. Your speed toward the island has slowed to a crawl.

You can see a centered positioned sail here.

>l
Journeying On The Waves (on the piece of wood)
A brisk westward wind is blowing. The sun hangs low in the sky over a distant island. You speed ahead toward the island as the wind catches your fancy jacket-sail.

You can see a centered positioned sail here.

>turn left
You can't see any such thing.

>turn sail left
You twist the mast slightly to the left.

>l
Journeying On The Waves (on the piece of wood)
A brisk westward wind is blowing. The sun hangs low in the sky over a distant island. Your speed toward the island has slowed to a crawl.

You can see a left positioned sail here.

>turn sail right
You twist the mast slightly to the right.

The wind suddenly shifts to the westward! You speed ahead toward the island as the wind catches your fancy jacket-sail.

>l
Journeying On The Waves (on the piece of wood)
A brisk westward wind is blowing. The sun hangs low in the sky over a distant island. You speed ahead toward the island as the wind catches your fancy jacket-sail.

You can see a centered positioned sail here.

* * *

>l
Journeying On The Waves (on the piece of wood)
A brisk southwestward wind is blowing. The sun hangs low in the sky over a distant island. Your speed toward the island has slowed to a crawl.

You can see a right positioned sail here.

>l
Journeying On The Waves (on the piece of wood)
A brisk southwestward wind is blowing. The sun hangs low in the sky over a distant island. Your speed toward the island has slowed to a crawl.

You can see a right positioned sail here.

* * *

>turn sail left
You twist the mast slightly to the left.

>l
Journeying On The Waves (on the piece of wood)
A brisk southwestward wind is blowing. The sun hangs low in the sky over a distant island. Your speed toward the island has slowed to a crawl.

You can see a centered positioned sail here.

* * *

>l
Journeying On The Waves (on the piece of wood)
A brisk southwestward wind is blowing. The sun hangs low in the sky over a distant island. Your speed toward the island has slowed to a crawl.

You can see a centered positioned sail here.

The wind suddenly shifts to the southwestward! Your speed toward the island has slowed to a crawl.

>l
Journeying On The Waves (on the piece of wood)
A brisk southwestward wind is blowing. The sun hangs low in the sky over a distant island. Your speed toward the island has slowed to a crawl.

You can see a centered positioned sail here.

>l
Journeying On The Waves (on the piece of wood)
A brisk westward wind is blowing. The sun hangs low in the sky over a distant island. You speed ahead toward the island as the wind catches your fancy jacket-sail.

You can see a centered positioned sail here.

* * *

>l
Journeying On The Waves (on the piece of wood)
A brisk westward wind is blowing. The sun hangs low in the sky over a distant island. You speed ahead toward the island as the wind catches your fancy jacket-sail.

You can see a centered positioned sail here.

The wind suddenly shifts to the westward! You speed ahead toward the island as the wind catches your fancy jacket-sail.

>l
Journeying On The Waves (on the piece of wood)
A brisk westward wind is blowing. The sun hangs low in the sky over a distant island. You speed ahead toward the island as the wind catches your fancy jacket-sail.

You can see a centered positioned sail here.

The wind suddenly shifts to the southwestward! Your speed toward the island has slowed to a crawl.

>l
Journeying On The Waves (on the piece of wood)
A brisk southwestward wind is blowing. The sun hangs low in the sky over a distant island. Your speed toward the island has slowed to a crawl.

You can see a centered positioned sail here.

The wind suddenly shifts to the southwestward! Your speed toward the island has slowed to a crawl.

* * *

>l
Journeying On The Waves (on the piece of wood)
A brisk southwestward wind is blowing. The sun hangs low in the sky over a distant island. Your speed toward the island has slowed to a crawl.

You can see a centered positioned sail here.

>l
Journeying On The Waves (on the piece of wood)
A brisk southwestward wind is blowing. The sun hangs low in the sky over a distant island. Your speed toward the island has slowed to a crawl.

You can see a centered positioned sail here.

* * *

>get jacket
You can't hold the jacket and swim. You can barely stay above water as it is.

>wear jacket
You put on the jacket.

* * *

>n
Glittering Waves
....  You tread water, and you are getting exhausted.  What is left of a human body floats on the surface here.  Something has been eating it.

On the body is a jacket.

You think you must have hit your head against the ship during the fall, because a small raised lump on the back of your skull is throbbing.

What next?

>get knife
You can't see any such thing.

>put knife in pocket
You can't see any such thing.

>close pocket
It isn't something you can close.

>get knife
You can't see any such thing.

>open pocket
It isn't something you can open.

* * *

>n
Glittering Waves
....  You tread water, and you are getting exhausted.  What is left of a human body floats on the surface here.  Something has been eating it.

On the body is a jacket.

You think you must have hit your head against the ship during the fall, because a small raised lump on the back of your skull is throbbing.

What next?

>l
Floating Object
A body seems to have been the source of a partial meal.

On the body is a jacket.

The wind suddenly shifts to the southwestward! Your speed toward the island has slowed to a crawl.

>s
Ocean Waves
 You lay on your back in the warm water as the waves lift your body up and down rythmically.  The sun's relentless heat beats down on you and the salt spray stings your eyes. The sea laps against your face and sometimes over it.  When it does, you spout like a tiny human whale.

The wind suddenly shifts to the southwestward! Your speed toward the island has slowed to a crawl.

>w
Rippling Waves
You cling to a piece of wood.  It seems to have been part of a boat at one time..

The wind suddenly shifts to the northwestward! Your speed toward the island has slowed to a crawl.

>get wood
That's fixed in place.

>e
Ocean Waves
 You lay on your back in the warm water as the waves lift your body up and down rythmically.  The sun's relentless heat beats down on you and the salt spray stings your eyes. The sea laps against your face and sometimes over it.  When it does, you spout like a tiny human whale.

>n
Floating Object
A body seems to have been the source of a partial meal.

On the body is a jacket.

The wind suddenly shifts to the southwestward! Your speed toward the island has slowed to a crawl.

>get jacket
Taken.

The wind suddenly shifts to the southwestward! Your speed toward the island has slowed to a crawl.

>s
Ocean Waves
 You lay on your back in the warm water as the waves lift your body up and down rythmically.  The sun's relentless heat beats down on you and the salt spray stings your eyes. The sea laps against your face and sometimes over it.  When it does, you spout like a tiny human whale.

>w
Rippling Waves
You cling to a piece of wood.  It seems to have been part of a boat at one time..

The wind suddenly shifts to the westward! You speed ahead toward the island as the wind catches your fancy jacket-sail.

>get on wood
You mount the piece of wood.

>get off wood
You dismount the piece of wood.

Rippling Waves
You cling to a piece of wood.  It seems to have been part of a boat at one time..

>e
Ocean Waves
 You lay on your back in the warm water as the waves lift your body up and down rythmically.  The sun's relentless heat beats down on you and the salt spray stings your eyes. The sea laps against your face and sometimes over it.  When it does, you spout like a tiny human whale.

>n
Floating Object
A body seems to have been the source of a partial meal.

>ne
You can't go that way.

>ne
You can't go that way.

>s
Ocean Waves
 You lay on your back in the warm water as the waves lift your body up and down rythmically.  The sun's relentless heat beats down on you and the salt spray stings your eyes. The sea laps against your face and sometimes over it.  When it does, you spout like a tiny human whale.

>ne
Even More Open Water
A stick of very wet driftwood, about six feet long and and one inch thick.

The wind suddenly shifts to the northwestward! Your speed toward the island has slowed to a crawl.

>get stick
Taken.

>sw
Ocean Waves
 You lay on your back in the warm water as the waves lift your body up and down rythmically.  The sun's relentless heat beats down on you and the salt spray stings your eyes. The sea laps against your face and sometimes over it.  When it does, you spout like a tiny human whale.

The wind suddenly shifts to the northwestward! Your speed toward the island has slowed to a crawl.

>w
Rippling Waves
You cling to a piece of wood.  It seems to have been part of a boat at one time..

* * *

>get on wood
You mount the piece of wood.

>l
Rippling Waves (on the piece of wood)
The wind suddenly shifts to the northwestward! Your speed toward the island has slowed to a crawl.

* * *

>n
Glittering Waves
....  You tread water, and you are getting exhausted.  What is left of a human body floats on the surface here.  Something has been eating it.

On the body is a jacket.

You think you must have hit your head against the ship during the fall, because a small raised lump on the back of your skull is throbbing.

What next?

>look at body
The body floats face down.  Something has taken a chunk out of its side.

On the body is a jacket.

>examine jacket
It's an olive-drav green military fatigue jacket with oversized pockets.

>look in pocket
In pocket is a knife.

>get knife
You can't hold the knife and swim. You can barely stay above water as it is.

>e
Even More Open Water
 You tread water to stay afloat. You're getting tired.  There is a stick of very wet driftwood here, about six feet long and and one inch thick.

>s
Open Water
 You tread water to stay above water. All that at effort is making you really tired. If only you had something to float on. Nothing but more water can be seen in all directions.

You're getting so tired of treading water, and the waves are kicking up some in wind. You have to get out of the water soon.

>w
Ocean Waves
 You lay on your back in the warm water as your body floats up and down the rythmic waves. The hot sun beats down on you and there is not a cloud in the clear blue sky.

>w
Rippling Waves
 You see a piece of wood about six feet in length. You swim over and cling to it gratefully. You look at the wood, and a surge of hope goes through you. This is actually a board that has been roughly hewn from a log.

You can see a piece of wood here.

You are suddenly exhausted, you try to resume floating on your back again, but the waves are higher now and sweep you under.  You reach for the surface as you sink into the gloom.

    *** You have drowned. ***

Would you like to RESTART, RESTORE a saved game, QUIT or UNDO the last command?

* * *

>n
Glittering Waves
....  You tread water, and you are getting exhausted.  What is left of a human body floats on the surface here.  Something has been eating it.

On the body is a jacket.

You think you must have hit your head against the ship during the fall, because a small raised lump on the back of your skull is throbbing.

What next?

>look at jacket
It's an olive-drav green military fatigue jacket with over sized pockets.

>examine pockets
You see nothing special about pockets.

>examine pockets
You can't see any such thing.

>examine pocket
You see nothing special about the pocket.

* * *

>n
Glittering Waves
....  You tread water, and you are getting exhausted.  What is left of a human body floats on the surface here.  Something has been eating it.

On the body is a jacket.

You think you must have hit your head against the ship during the fall, because a small raised lump on the back of your skull is throbbing.

What next?

>look at the body
The body floats face down.  Something has taken a chunk out of its side.

On the body is a jacket.

>get the jacket
You can't hold the jacket and swim. You can barely stay above water as it is.

>e
Even More Open Water
 You tread water to stay afloat. You're getting tired.  There is a stick of very wet driftwood here, about six feet long and and one inch thick.

>get stick
You can't hold the stick and swim. You can barely stay above water as it is.

>w
Floating Object
 You tread water to stay afloat. You're getting tired.  What is left of a human body floats on the surface here.  Something has been eating on it.

On the body is a jacket.

>s
Ocean Waves
 You lay on your back in the warm water as your body floats up and down the rythmic waves. 

You're getting so tired of treading water, and the waves are kicking up some in wind. You have to get out of the water soon.

>w
Rippling Waves
 You see a piece of wood about six feet in length. You swim over and cling to it gratefully. You look at the wood, and a surge of hope goes through you. This is actually a board that has been roughly hewn from a log.

You can see a piece of wood here.

* * *

>n
Glittering Waves
....  You tread water, and you are getting exhausted.  What is left of a human body floats on the surface here.  Something has been eating it.

On the body is a jacket.

You think you must have hit your head against the ship during the fall, because a small raised lump on the back of your skull is throbbing.

What next?

>open pocket
It isn't something you can open.

* * *

>n
Glittering Waves
....  You tread water, and you are getting exhausted.  What is left of a human body floats on the surface here.  Something has been eating it.

On the body is a jacket.

You think you must have hit your head against the ship during the fall, because a small raised lump on the back of your skull is throbbing.

What next?

>s
Ocean Waves
....  You lay on your back in the warm water as your body floats up and down the rythmic waves. The hot sun beats down on you and there is not a cloud in the clear blue sky.  Say look, or north, east, west south to move.

You can see a bug here.

This really sucks. You could be kicking back right now having an ice-cold drink in the ship's lounge.

What next?

>e
Open Water
 You tread water to stay afloat.  You're getting tired. Nothing but more water can be seen.

>w
Ocean Waves
 You lay on your back in the warm salt water as the waves lift your body up and down rythmically.  The sun's relentless heat beats down on you and the salt water stings your eyes. The sea water laps against your face and sometimes over it.  You sputter out a little water in a spray like a tiny human whale.

>s
More Open Water
 You tread water to stay afloat.  You're getting tired.  Nothing but more water can be seen.

>n
Ocean Waves
 You lay on your back in the warm salt water as the waves lift your body up and down rythmically.  The sun's relentless heat beats down on you and the salt water stings your eyes. The sea water laps against your face and sometimes over it.  You sputter out a little water in a spray like a tiny human whale.

>w
Rippling Waves
You cling to a piece of wood.  It seems to have been part of a boat at one time.

>get on board
You can't see any such thing.

>get on wood
You mount the piece of wood.

>l
Rippling Waves (on the piece of wood)

>e
Ocean Waves (on the piece of wood)
 The water laps at the plank you sit on, rocking you up and down.

* * *

>w
Ocean Waves (on the piece of wood)
 The water laps at the plank you sit on, rocking you up and down.

>s
More Open Water (on the piece of wood)
 Nothing but more water can be seen.

>n
Ocean Waves (on the piece of wood)
 The water laps at the plank you sit on, rocking you up and down.

>n
Small Floating Object (on the piece of wood)
A body seems to have been the source of a partial meal.

On the body is a jacket.

>get jacket
Taken.

* * *

>s
Ocean Waves
....  You lay on your back in the warm water as your body floats up and down the rythmic waves. The hot sun beats down on you and there is not a cloud in the clear blue sky.  Say look, or north, east, west south to move.

You can see a bug here.

This really sucks. You could be kicking back right now having an ice-cold drink in the ship's lounge.

What next?

>l
Ocean Waves
....  You lay on your back in the warm water as your body floats up and down the rythmic waves. The hot sun beats down on you and there is not a cloud in the clear blue sky. 

You can see a bug here.

At least one good thing has come of all this, you won't have to worry about ending your vacation any time soon.

What next?  You can say, help, to get more information on how to play.

>l
Ocean Waves
....  You lay on your back in the warm water as your body floats up and down the rythmic waves. The hot sun beats down on you and there is not a cloud in the clear blue sky. 

You can see a bug here.

What next?

>l
Ocean Waves
....  You lay on your back in the warm water as your body floats up and down the rythmic waves. The hot sun beats down on you and there is not a cloud in the clear blue sky. 

You can see a bug here.

What next?

>restart
Are you sure you want to restart?

>y
.... You are floating in the middle of a tropical ocean.  You hoped that the cruise ship would notice you were missing, but it's been hours, and no ship has appeared on the horizon. You deeply regret trying to stop your phone from falling over the railing of the ship. Now look what's happened.

Alien Shores....
An Interactive Fiction by Keith B Phillips.... Say look, or north, east, west south to move.
Release 1 / Serial number 180911 / Inform 7 build 6M62 (I6/v6.33 lib 6/12N) SD

Ocean Waves
....  You lay on your back in the warm water as your body floats up and down the rythmic waves. The hot sun beats down on you and there is not a cloud in the clear blue sky.  Say look, or north, east, west south to move.

You can see a bug here.

>l
Ocean Waves
....  You lay on your back in the warm water as your body floats up and down the rythmic waves. The hot sun beats down on you and there is not a cloud in the clear blue sky.  Say look, or north, east, west south to move.

You can see a bug here.

You think you must have hit your head against the ship during the fall, because a small raised lump on the back of your skull is throbbing.

What next?

>l
Ocean Waves
....  You lay on your back in the warm water as your body floats up and down the rythmic waves. The hot sun beats down on you and there is not a cloud in the clear blue sky. 

You can see a bug here.

This really sucks. You could be kicking back right now having an ice-cold drink in the ship's lounge.

What next?  You can say, help, to get more information on how to play.

>l
Ocean Waves
....  You lay on your back in the warm water as your body floats up and down the rythmic waves. The hot sun beats down on you and there is not a cloud in the clear blue sky. 

You can see a bug here.

At least one good thing has come of all this, you won't have to worry about ending your vacation any time soon.

What next?

>w
Rippling Waves
....  You see a piece of wood about six feet in length. You swim over and cling to it gratefully. You look at the wood, and a surge of hope goes through you. This is actually a wide board that has been roughly hewn from a log.

You can see a piece of wood here.

What next?

>e
Ocean Waves
....  You lay on your back in the warm water as your body floats up and down the rythmic waves. The hot sun beats down on you and there is not a cloud in the clear blue sky.  Say look, or north, east, west south to move.

You can see a bug here.

What next?

>help
That's not a verb I recognise.

What next?

* * *

>s
Ocean Waves
....  You lay on your back in the warm water as your body floats up and down the rythmic waves. The hot sun beats down on you and there is not a cloud in the clear blue sky.  Say look, or north, east, west south to move.

You can see a bug here.

This really sucks. You could be kicking back right now having an ice-cold drink in the ship's lounge.

What next?

>n
Small Floating Object
A body seems to have been the source of a partial meal.

On the body is a jacket.

>get jacket
Taken.

* * *

>l
Piece Of Debri
You cling to the piece of wood.  It seems to have been part of a boat at one time.

>examine wood
You see nothing special about the piece of wood.

>get on wood
You mount the piece of wood.

>n
You can't go that way.

>e
Ocean Waves (on the piece of wood)
You lay on your back in the warm salt water as the waves lift your body up and down rythmically.   The sea water laps against your face and sometimes over it.  You sputter out a little water in a spray like a tiny human whale.

>s
More Open Water (on the piece of wood)
You tread water.  Nothing but more water can be seen.

* * *

>s
Ocean Waves
....  You lay on your back in the warm water as your body floats up and down the rythmic waves. The hot sun beats down on you and there is not a cloud in the clear blue sky.  Say look, or north, east, west south to move.

You can see a bug here.

This really sucks. You could be kicking back right now having an ice-cold drink in the ship's lounge.

What next?

>s
More Open Water
 You tread water to stay afloat.  You're getting tired.  Nothing but more water can be seen.

* * *

>n
Ocean Waves
 You lay on your back in the warm water as the waves lift your body up and down rythmically.  The sun's relentless heat beats down on you and the salt spray stings your eyes. The sea laps against your face and sometimes over it.  When it does, you spout like a tiny human whale.

>e
Open Water
 You tread water to stay afloat.  You're getting tired. If only you had something to float on. Nothing but more water can be seen.

>w
Ocean Waves
 You lay on your back in the warm water as the waves lift your body up and down rythmically.  The sun's relentless heat beats down on you and the salt spray stings your eyes. The sea laps against your face and sometimes over it.  When it does, you spout like a tiny human whale.

>n
Floating Object
A body seems to have been the source of a partial meal.

On the body is a jacket.

* * *

>s
Ocean Waves
....  You lay on your back in the warm water as your body floats up and down the rythmic waves. The hot sun beats down on you and there is not a cloud in the clear blue sky.  Say look, or north, east, west south to move.

You can see a bug here.

This really sucks. You could be kicking back right now having an ice-cold drink in the ship's lounge.

What next?

>w
Rippling Waves
....  You see a piece of wood about six feet in length. You swim over and cling to it gratefully. You look at the wood, and a surge of hope goes through you. This is actually a wide board that has been roughly hewn from a log.

You can see a piece of wood here.

At least one good thing has come of all this, you won't have to worry about ending your vacation any time soon.

>get on wood
Thank goodness!  You were getting exhausted just trying to stay a float.

You mount the piece of wood.

>e
Ocean Waves (on the piece of wood)
....  The water laps at the plank you sit on, rocking you up and down. You can see a dark object bobbing on the surface to the North.

>n
Glittering Waves (on the piece of wood)
....  What is left of a human body floats on the surface here.  Something has been eating it.

On the body is a jacket.

>get jacket
The body is badly decayed. You can't tell if it was male or female.  Your stomach churns from the smell, but you grit your teeth and strip the jacket off.

Taken.

>e
Even More Open Water (on the piece of wood)
....  There is a stick of very wet driftwood here, about six feet long and and one inch thick.

>drop jacket
Dropped.

>l
Even More Open Water (on the piece of wood)
....  There is a stick of very wet driftwood here, about six feet long and and one inch thick.

On the piece of wood you can see a jacket.

>get jacket
Taken.

>get stick
Taken.

* * *

>put stick in hole
You place the driftwood stick into the knothole. It's a tight fit, but you manage it. Your little plank surfboard now has a mast.

>put the jacket on the stick
You drape the jacket over the stick by the collar.
The wind catches the jacket and pulls you along over the waves.

Journeying On The Waves (on the piece of wood)
.... A brisk westward wind is blowing and the sun hangs low in the sky. In the distance you can barely make out the shape of an island jutting above the waves

You can see a centered positioned sail here.

Wind is 2 and sail is 2 and the island is 0.
There is the faint outline of an island in the distance.

>l
Journeying On The Waves (on the piece of wood)
.... A brisk westward wind is blowing and the sun hangs low in the sky. You speed ahead toward the island as the wind catches your centered positioned sail.

Wind is 2 and sail is 2 and the island is 0.
The wind suddenly shifts to a northwestward wind!
There is the faint outline of an island in the distance.

>l
Journeying On The Waves (on the piece of wood)
.... A brisk northwestward wind is blowing and the sun hangs low in the sky. Your speed toward the island has slowed to a crawl.

You can see a centered positioned sail here.

Wind is 1 and sail is 2 and the island is -1.
There is the faint outline of an island in the distance.

>l
Journeying On The Waves (on the piece of wood)
.... A brisk northwestward wind is blowing and the sun hangs low in the sky. Your speed toward the island has slowed to a crawl.

You can see a centered positioned sail here.

Wind is 1 and sail is 2 and the island is -1.
There is the faint outline of an island in the distance.

>turn sail right
You twist the mast slightly to the right.

Wind is 1 and sail is 3 and the island is -2.
There is the faint outline of an island in the distance.

>look
Journeying On The Waves (on the piece of wood)
.... A brisk northwestward wind is blowing and the sun hangs low in the sky. Your speed toward the island has slowed to a crawl.

You can see a right positioned sail here.

Wind is 1 and sail is 3 and the island is -2.
There is the faint outline of an island in the distance.

>look
Journeying On The Waves (on the piece of wood)
.... A brisk northwestward wind is blowing and the sun hangs low in the sky. Your speed toward the island has slowed to a crawl.

You can see a right positioned sail here.

Wind is 1 and sail is 3 and the island is -2.
There is the faint outline of an island in the distance.

>l
Journeying On The Waves (on the piece of wood)
.... A brisk northwestward wind is blowing and the sun hangs low in the sky. Your speed toward the island has slowed to a crawl.

You can see a right positioned sail here.

Wind is 1 and sail is 3 and the island is -2.
There is the faint outline of an island in the distance.

>l
Journeying On The Waves (on the piece of wood)
.... A brisk northwestward wind is blowing and the sun hangs low in the sky. Your speed toward the island has slowed to a crawl.

You can see a right positioned sail here.

Wind is 1 and sail is 3 and the island is -2.
A northwestward wind continues to blow.
There is the faint outline of an island in the distance.

>turn sail left
You twist the mast slightly to the left.

Wind is 1 and sail is 2 and the island is -1.
A northwestward wind continues to blow.
There is the faint outline of an island in the distance.

>look
Journeying On The Waves (on the piece of wood)
.... A brisk northwestward wind is blowing and the sun hangs low in the sky. Your speed toward the island has slowed to a crawl.

You can see a centered positioned sail here.

Wind is 1 and sail is 2 and the island is -1.
A northwestward wind continues to blow.
There is the faint outline of an island in the distance.

>turn sail left
You twist the mast slightly to the left.

Wind is 1 and sail is 1 and the island is 0.
There is the faint outline of an island in the distance.

>look
Journeying On The Waves (on the piece of wood)
.... A brisk northwestward wind is blowing and the sun hangs low in the sky. You speed ahead toward the island as the wind catches your left positioned sail.

Wind is 1 and sail is 1 and the island is 0.
The wind suddenly shifts to a westward wind!
There is the faint outline of an island in the distance.

A grey fin emerges from the waves. Adrenaline kicks in, but you manage to hold yourself together.  You guide your make-shift sailboard away from the creature until the fin submerges. For a moment you feel somewhat relieved, and then you wonder where the creature has gone to.

>turn sail right
You twist the mast slightly to the right.

Wind is 2 and sail is 2 and the island is 0.

A grey fin emerges from the waves. Adrenaline kicks in, but you manage to hold yourself together.  You guide your make-shift sailboard away from the creature until the fin submerges. For a moment you feel somewhat relieved, and then you wonder where the creature has gone to.

>look
Journeying On The Waves (on the piece of wood)
.... A brisk westward wind is blowing and the sun hangs low in the sky. You speed ahead toward the island as the wind catches your centered positioned sail.

Wind is 2 and sail is 2 and the island is 0.
The island is getting closer.

A grey fin emerges from the waves. Adrenaline kicks in, but you manage to hold yourself together.  You guide your make-shift sailboard away from the creature until the fin submerges. For a moment you feel somewhat relieved, and then you wonder where the creature has gone to.

>look
Journeying On The Waves (on the piece of wood)
.... A brisk westward wind is blowing and the sun hangs low in the sky. You speed ahead toward the island as the wind catches your centered positioned sail.

Wind is 2 and sail is 2 and the island is 0.
A westward wind continues to blow.
The island is getting closer.

A grey fin emerges from the waves. Adrenaline kicks in, but you manage to hold yourself together.  You guide your make-shift sailboard away from the creature until the fin submerges. For a moment you feel somewhat relieved, and then you wonder where the creature has gone to.

>turn sail right
You twist the mast slightly to the right.

Wind is 2 and sail is 3 and the island is -1.
The island is getting closer.

A grey fin emerges from the waves. Adrenaline kicks in, but you manage to hold yourself together.  You guide your make-shift sailboard away from the creature until the fin submerges. For a moment you feel somewhat relieved, and then you wonder where the creature has gone to.
Suddenly the shark reappears next to your board.  This time it is too quick.  Eons of evolution has turned it into the perfect predator. You look over and see a big toothy grin. You imagine he's your pal, just surfing along with you on the waves, having a good time. It's easier that way.  The end comes in the blink of eye.

    *** You have been eaten. ***

Would you like to RESTART, RESTORE a saved game, QUIT or UNDO the last command?

>look
Please give one of the answers above.

Would you like to RESTART, RESTORE a saved game, QUIT or UNDO the last command?

>north
Please give one of the answers above.

Would you like to RESTART, RESTORE a saved game, QUIT or UNDO the last command?

>get off the wood
Please give one of the answers above.

Would you like to RESTART, RESTORE a saved game, QUIT or UNDO the last command?

>n
Please give one of the answers above.

Would you like to RESTART, RESTORE a saved game, QUIT or UNDO the last command?

>look at Sea Turtle
Please give one of the answers above.

Would you like to RESTART, RESTORE a saved game, QUIT or UNDO the last command?

>ride turtle
Please give one of the answers above.

Would you like to RESTART, RESTORE a saved game, QUIT or UNDO the last command?

* * *

>n
Glittering Waves
....  You tread water, and you are getting exhausted.  What is left of a human body floats on the surface here.  Something has been eating it.

On the body is a jacket.

You think you must have hit your head against the ship during the fall, because a small raised lump on the back of your skull is throbbing.

What next?

>search body
In the body is a knife.

* * *

>n
Glittering Waves
....  You tread water, and you are getting exhausted.  What is left of a human body floats on the surface here.  Something has been eating it.

On the body is a jacket.

You think you must have hit your head against the ship during the fall, because a small raised lump on the back of your skull is throbbing.

What next?

>w
You begin to paddle in that direction but without a plan or destination you soon lose hope and return.

>e
Even More Open Water
 You tread water to stay afloat. You're getting tired.  A stick of very wet driftwood, about six feet long and and one inch thick.

* * *

>w
Floating Object
 You tread water to stay afloat. You're getting tired.  A body seems to have been the source of a partial meal.

On the body is a jacket.

>get jacket
You can't hold the jacket and swim. You can barely stay above water as it is.

* * *

>s
Ocean Waves
 You lay on your back in the warm water as the waves lift your body up and down rythmically.

>w
Rippling Waves
 You see a piece of wood about six feet in length. You swim over and cling to it gratefully. You look at the wood, and a surge of hope goes through you. This is actually a board that has been roughly hewn from log.

You can see a piece of wood here.

You're getting so tired of treading water, and the waves are kicking up some in wind. You have to get out of the water soon.

>get on wood
Thank goodness!  You were getting exhausted just trying to stay alfloat.

You mount the piece of wood.

>e
Ocean Waves (on the piece of wood)
 The water laps at the plank you sit on, rocking you up and down.  A dark object bobs up and down on the surface to the North.

>n
Floating Object (on the piece of wood)
 A body seems to have been the source of a partial meal.

On the body is a jacket.

>get jacket
The body is badly decayed. You can't tell if it was male or female.  Your stomach churns from the smell, but you grit your teeth and strip the jacket off.

* * *

>ne
Even More Open Water
 You tread water to stay afloat. You're getting tired.  A stick of very wet driftwood, about six feet long and and one inch thick.

>get on stick
That's not something you can enter.

>get stick
Taken.

>w
You begin to paddle in that direction but without a plan or destination you soon lose hope and return.

* * *

>s
You begin to paddle in that direction but without a plan or destination you soon lose hope and return.

>sw
Ocean Waves
 You lay on your back in the warm water as the waves lift your body up and down rythmically.  The sun's relentless heat beats down on you and the salt spray stings your eyes. The sea laps against your face and sometimes over it.  When it does, you spout like a tiny human whale.

* * *

>get stick
You can't hold the stick and swim.

>i
You are carrying nothing.

>w
You begin to paddle in that direction but without a plan or destination you soon lose hope and return.

* * *

>e
Ocean Waves (on the piece of wood)
 The water laps at the plank you sit on, rocking you up and down.

>ne
Even More Open Water (on the piece of wood)
 A stick of very wet driftwood, about six feet long and and one inch thick.

>get the stick
You can't hold the stick and swim.

* * *

>get stick
You can't hold the stick and swim.

>inventory
You are carrying nothing.

>sw
Ocean Waves
 You lay on your back in the warm water as the waves lift your body up and down rythmically.  The sun's relentless heat beats down on you and the salt spray stings your eyes. The sea laps against your face and sometimes over it.  When it does, you spout like a tiny human whale.

* * *

>w
Rippling Waves
You cling to a piece of wood.  It seems to have been part of a boat at one time..

>w
You begin to paddle in that direction but without a plan or destination you soon lose hope and return.

>get on board
You mount the piece of wood.

>e
Ocean Waves (on the piece of wood)
 The water laps at the plank you sit on, rocking you up and down.

* * *

>inventory
You are carrying nothing.

>w
You begin to paddle in that direction but without a plan or destination you soon lose hope and return.

* * *

>ne
Even More Open Water (on the piece of wood)
 A stick of very wet driftwood, about six feet long and and one inch thick.

>get stick
You won't be able to swim if you are holding that.

* * *

>get stick
You can't hold the stick and swim.

>sw
Ocean Waves
 You lay on your back in the warm water as the waves lift your body up and down rythmically.  The sun's relentless heat beats down on you and the salt spray stings your eyes. The sea laps against your face and sometimes over it.  When it does, you spout like a tiny human whale.

>n
Floating Object
A body seems to have been the source of a partial meal.

On the body is a jacket.

* * *

>w
Rippling Waves
You cling to a piece of wood.  It seems to have been part of a boat at one time..

>get on board
You mount the piece of wood.

>put stick in knothole
You place the driftwood stick into the knothole. It's tight fit but you manage it. Your little plank surfboard now has a mast.

* * *

>l
Journing On The Waves (on the piece of wood)
You continue to be totally swept along westward toward the sun that hangs over the sea in the sky.  You begin to see something peeking above the horizon of waves in the distance.

You can see a sail here.

>l
Journing On The Waves (on the piece of wood)
You continue to be totally swept along westward toward the sun that hangs over the sea in the sky.  You begin to see something peeking above the horizon of waves in the distance.

You can see a sail here.

>n
You begin to paddle in that direction but without a plan or destination you soon lose hope and return.

* * *

>w
You begin to paddle in that direction but without a plan or destination you soon lose hope and return.

>e
You begin to paddle in that direction but without a plan or destination you soon lose hope and return.

>s
You begin to paddle in that direction but without a plan or destination you soon lose hope and return.

>ne
You begin to paddle in that direction but without a plan or destination you soon lose hope and return.

>nw
You begin to paddle in that direction but without a plan or destination you soon lose hope and return.

>se
You begin to paddle in that direction but without a plan or destination you soon lose hope and return.

>l
Journing On The Waves (on the piece of wood)
You continue to be totally swept along westward toward the sun that hangs over the sea in the sky.  You begin to see something peeking above the horizon of waves in the distance.

You can see a sail here.

>examine wood
It's a sturdy plank of the type used to make wooden hulls. There is a small knothole in the middle of it.

>examine mast
You can't see any such thing.

>examine sail
The sail is currently switched off.

* * *

>w
Rippling Waves
You cling to a piece of wood.  It seems to have been part of a boat at one time..

>put stick into knothole
You place the driftwood stick into the knothole. It's tight fit but you manage it. Your little plank surfboard now has a mast.

>put jacket on stick
You drape the jacket over the stick by the collar.
The wind catches the jacket and pulls you along over the waves.

Rushing Waves (on the piece of wood)
You rush along the tops of the waves as the wind blows your makeshift sail.  The board is slippery and wet and hits the occasional wave just so, sending a spray into your face, almost knocking you from the board. You cling to the fragile looking stick of driftwood desperately hoping that it will hold and keep you on the board.

>get on wood
You are already riding the piece of wood.

>l
Rushing Waves (on the piece of wood)
You rush along the tops of the waves as the wind blows your makeshift sail.  The board is slippery and wet and hits the occasional wave just so, sending a spray into your face, almost knocking you from the board. You cling to the fragile looking stick of driftwood desperately hoping that it will hold and keep you on the board.

>l
Journeying On The Waves (on the piece of wood)
You continue to be swept along by a brisk westward wind. The sun hangs low in the sky over the sea. You see an island to the westward peeking above the horizon of waves in the distance.

You can see a sail here.

>look at sail
You see nothing special about the sail.

>turn sail
Nothing obvious happens.

>turn wood
It is fixed in place.

>turn jacket
Nothing obvious happens.

>turn sail
Nothing obvious happens.

>turn sail left
You twist the mast slightly to the left.

>turn sail
Nothing obvious happens.

>turn sail
Nothing obvious happens.

>l
Journeying On The Waves (on the piece of wood)
You continue to be swept along by a brisk westward wind. The sun hangs low in the sky over the sea. You see an island to the westward peeking above the horizon of waves in the distance.

You can see a left positioned sail here.

>turn sail
Nothing obvious happens.

>l
Journeying On The Waves (on the piece of wood)
You continue to be swept along by a brisk northwestward wind. The sun hangs low in the sky over the sea. You see an island to the westward peeking above the horizon of waves in the distance.

You can see a left positioned sail here.

>turn sail center
I only understood you as far as wanting to turn the left positioned sail.

>turn sail
Nothing obvious happens.

* * *

>l
Journeying On The Waves (on the piece of wood)
You continue to be swept along by a brisk northwestward wind. The sun hangs low in the sky over the sea. You see an island to the westward peeking above the horizon of waves in the distance.

You can see a left positioned sail here.

>turn sail left
You twist the mast slightly to the left.

>turn sail right
You twist the mast slightly to the right.

>turn the sail right
You twist the mast slightly to the right.

>turn sail left
You twist the mast slightly to the left.

* * *

>turn sail right
You twist the mast slightly to the right.

>turn sail left
You twist the mast slightly to the left.

I beg your pardon?

I beg your pardon?

* * *

>turn sail right
You twist the mast slightly to the right.

>l
Journeying On The Waves (on the piece of wood)
You continue to be swept along by a brisk westward wind. The sun hangs low in the sky over the sea. You see an island to the northwestward peeking above the horizon of waves in the distance.

You can see a right positioned sail here.

I beg your pardon?

>turn the sail right
You twist the mast slightly to the right.

>turn the sail left
You twist the mast slightly to the left.

>l
Journeying On The Waves (on the piece of wood)
You continue to be swept along by a brisk southwestward wind. The sun hangs low in the sky over the sea. You see an island to the northwestward peeking above the horizon of waves in the distance.

You can see a left positioned sail here.

>you twist the sail left
That's not a verb I recognise.

>the turn the sail left
That's not a verb I recognise.

>turn the sail left
You twist the mast slightly to the left.

>turn the sail right
You twist the mast slightly to the right.

>l
Journeying On The Waves (on the piece of wood)
You continue to be swept along by a brisk southwestward wind. The sun hangs low in the sky over the sea. You see an island to the northwestward peeking above the horizon of waves in the distance.

You can see a right positioned sail here.

>l
Journeying On The Waves (on the piece of wood)
You continue to be swept along by a brisk southwestward wind. The sun hangs low in the sky over the sea. You see an island to the northwestward peeking above the horizon of waves in the distance.

You can see a right positioned sail here.

>turn the sail right
You twist the mast slightly to the right.

>l
Journeying On The Waves (on the piece of wood)
You continue to be swept along by a brisk northwestward wind. The sun hangs low in the sky over the sea. You see an island to the northwestward peeking above the horizon of waves in the distance.

You can see a right positioned sail here.

>l
Journeying On The Waves (on the piece of wood)
You continue to be swept along by a brisk westward wind. The sun hangs low in the sky over the sea. You see an island to the northwestward peeking above the horizon of waves in the distance.

You can see a right positioned sail here.

>l
Journeying On The Waves (on the piece of wood)
You continue to be swept along by a brisk southwestward wind. The sun hangs low in the sky over the sea. You see an island to the northwestward peeking above the horizon of waves in the distance.

You can see a right positioned sail here.

>look at sail
You see nothing special about the right positioned sail.

>l
Journeying On The Waves (on the piece of wood)
You continue to be swept along by a brisk westward wind. The sun hangs low in the sky over the sea. You see an island to the northwestward peeking above the horizon of waves in the distance.

You can see a right positioned sail here.

* * *

>l
Journeying On The Waves (on the piece of wood)
You continue to be swept along by a brisk southwestward wind. The sun hangs low in the sky over the sea. You see an island to the northwestward peeking above the horizon of waves in the distance.

You can see a right positioned sail here.

>l
Journeying On The Waves (on the piece of wood)
You continue to be swept along by a brisk northwestward wind. The sun hangs low in the sky over the sea. You see an island to the northwestward peeking above the horizon of waves in the distance.

You can see a right positioned sail here.

>l
Journeying On The Waves (on the piece of wood)
You continue to be swept along by a brisk southwestward wind. The sun hangs low in the sky over the sea. You see an island to the northwestward peeking above the horizon of waves in the distance.

You can see a right positioned sail here.

* * *

>l
Journeying On The Waves (on the piece of wood)
You continue to be swept along by a brisk northwestward wind. The sun hangs low in the sky over the sea. You see an island to the northwestward peeking above the horizon of waves in the distance.

You can see a right positioned sail here.

>l
Journeying On The Waves (on the piece of wood)
You continue to be swept along by a brisk northwestward wind. The sun hangs low in the sky over the sea. You see an island to the northwestward peeking above the horizon of waves in the distance.

You can see a right positioned sail here.

* * *

>l
Journeying On The Waves (on the piece of wood)
You continue to be swept along by a brisk westward wind. The sun hangs low in the sky over the sea. You see an island to the northwestward peeking above the horizon of waves in the distance.

You can see a right positioned sail here.

>l
Journeying On The Waves (on the piece of wood)
You continue to be swept along by a brisk westward wind. The sun hangs low in the sky over the sea. You see an island to the northwestward peeking above the horizon of waves in the distance.

You can see a right positioned sail here.

* * *

>l
Journeying On The Waves (on the piece of wood)
You continue to be swept along by a brisk southwestward wind. The sun hangs low in the sky over the sea. You see an island to the northwestward peeking above the horizon of waves in the distance.

You can see a right positioned sail here.

>l
Journeying On The Waves (on the piece of wood)
You continue to be swept along by a brisk westward wind. The sun hangs low in the sky over the sea. You see an island to the northwestward peeking above the horizon of waves in the distance.

You can see a right positioned sail here.

>l
Journeying On The Waves (on the piece of wood)
You continue to be swept along by a brisk northwestward wind. The sun hangs low in the sky over the sea. You see an island to the northwestward peeking above the horizon of waves in the distance.

You can see a right positioned sail here.

* * *

>l
Journeying On The Waves (on the piece of wood)
You continue to be swept along by a brisk westward wind. The sun hangs low in the sky over the sea. You see an island to the northwestward peeking above the horizon of waves in the distance.

You can see a right positioned sail here.

>turn sail left
You twist the mast slightly to the left.

>l
Journeying On The Waves (on the piece of wood)
You continue to be swept along by a brisk southwestward wind. The sun hangs low in the sky over the sea. You see an island to the northwestward peeking above the horizon of waves in the distance.

You can see a left positioned sail here.

>turn the sail right
You twist the mast slightly to the right.

>l
Journeying On The Waves (on the piece of wood)
You continue to be swept along by a brisk southwestward wind. The sun hangs low in the sky over the sea. You see an island to the westward peeking above the horizon of waves in the distance.

You can see a right positioned sail here.

>l
Journeying On The Waves (on the piece of wood)
You continue to be swept along by a brisk westward wind. The sun hangs low in the sky over the sea. You see an island to the westward peeking above the horizon of waves in the distance.

You can see a right positioned sail here.

>l
Journeying On The Waves (on the piece of wood)
You continue to be swept along by a brisk southwestward wind. The sun hangs low in the sky over the sea. You see an island to the westward peeking above the horizon of waves in the distance.

You can see a right positioned sail here.

* * *

>l
Journeying On The Waves (on the piece of wood)
You continue to be swept along by a brisk westward wind. The sun hangs low in the sky over the sea. You see an island to the westward peeking above the horizon of waves in the distance.

You can see a right positioned sail here.

>l
Journeying On The Waves (on the piece of wood)
You continue to be swept along by a brisk westward wind. The sun hangs low in the sky over the sea. You see an island to the westward peeking above the horizon of waves in the distance.

You can see a right positioned sail here.

>turn sail left
You twist the mast slightly to the left.

>l
Journeying On The Waves (on the piece of wood)
You continue to be swept along by a brisk westward wind. The sun hangs low in the sky over the sea. You see an island to the westward peeking above the horizon of waves in the distance.

You can see a left positioned sail here.

>turn sail left
You twist the mast slightly to the left.

* * *

>l
Journeying On The Waves (on the piece of wood)
You continue to be swept along by a brisk southwestward wind. The sun hangs low in the sky over the sea. You see an island to the northwestward peeking above the horizon of waves in the distance.

You can see a left positioned sail here.

>turn sail right
You twist the mast slightly to the right.

* * *

>sw
Ocean Waves
 You lay on your back in the warm water as the waves lift your body up and down rythmically.  The sun's relentless heat beats down on you and the salt spray stings your eyes. The sea laps against your face and sometimes over it.  When it does, you spout like a tiny human whale.

>s
More Open Water
 You tread water to stay afloat.  You're getting tired.  Nothing but more water can be seen.

* * *

>n
Ocean Waves
 You lay on your back in the warm water as the waves lift your body up and down rythmically.  The sun's relentless heat beats down on you and the salt spray stings your eyes. The sea laps against your face and sometimes over it.  When it does, you spout like a tiny human whale.

>e
Open Water
 You tread water to stay afloat.  You're getting tired. Nothing but more water can be seen.

* * *

>put jacket on stick
You drape the jacket over the stick by the collar.

>put stick in knothole
You place the driftwood stick into the knothole. It's tight fit but you manage it. Your little plank surfboard now has a mast.
The wind catches the jacket and pulls you along over the waves.

Rushing Waves
You rush along the tops of the waves as the wind blows your makeshift sail.  The board is slippery and wet and hits the occasional wave just so, sending a spray into your face, almost knocking you from the board. You cling to the fragile looking stick of driftwood desperately hoping that it will hold and keep you on the board.

>l
Rushing Waves
You rush along the tops of the waves as the wind blows your makeshift sail.  The board is slippery and wet and hits the occasional wave just so, sending a spray into your face, almost knocking you from the board. You cling to the fragile looking stick of driftwood desperately hoping that it will hold and keep you on the board.

>l
Rushing Waves
You rush along the tops of the waves as the wind blows your makeshift sail.  The board is slippery and wet and hits the occasional wave just so, sending a spray into your face, almost knocking you from the board. You cling to the fragile looking stick of driftwood desperately hoping that it will hold and keep you on the board.

>l
Rushing Waves
You rush along the tops of the waves as the wind blows your makeshift sail.  The board is slippery and wet and hits the occasional wave just so, sending a spray into your face, almost knocking you from the board. You cling to the fragile looking stick of driftwood desperately hoping that it will hold and keep you on the board.

Island In The Distance
You can see an Island in the distance.

* * *

>w
Rippling Waves
You cling to a piece of wood.  It seems to have been part of a boat at one time..

>get on board
You can't see any such thing.

* * *

>get jacket
Taken.

>put stick in knothole
You place the driftwood stick into the knothole. It's tight fit but you manage it. Your little plank surfboard now has a mast.

* * *

>put jacket on stick
You drape the jacket over the stick by the collar.
The wind catches the jacket and pulls you along over the waves.

Rushing Waves
You rush along the tops of the waves as the wind blows your makeshift sail.  The board is slippery and wet and hits the occasional wave just so, sending a spray into your face, almost knocking you from the board. You cling to the fragile looking stick of driftwood desperately hoping that it will hold and keep you on the board.

>l
Rushing Waves
You rush along the tops of the waves as the wind blows your makeshift sail.  The board is slippery and wet and hits the occasional wave just so, sending a spray into your face, almost knocking you from the board. You cling to the fragile looking stick of driftwood desperately hoping that it will hold and keep you on the board.

* * *

>ne
Even More Open Water (on the piece of wood)
 A stick of very wet driftwood, about six feet long and and one inch thick.

>get stick
You won't be able to swim if you are holding that!

* * *

>get on wood
You mount the piece of wood.

>put stick on wood
Dropped.

>look
Rippling Waves (on the piece of wood)
On the piece of wood you can see a stick.

>e
Ocean Waves (on the piece of wood)
 The water laps at the plank you sit on, rocking you up and down.

On the piece of wood you can see a stick.

>n
Floating Object (on the piece of wood)
A body seems to have been the source of a partial meal.

On the body is a jacket.

On the piece of wood you can see a stick.

>get jacket
Taken.

>put jacket on stick
Putting things on the stick would achieve nothing.

* * *

>w
You begin to paddle in that direction but without a plan or destination you soon lose hope and return.

>get on wood
You mount the piece of wood.

* * *

>i
You are carrying nothing.

* * *

>get stick
Taken.

>i
You are carrying:
  a stick

>w
You begin to paddle in that direction but without a plan or destination you soon lose hope and return.

* * *

>ne
Even More Open Water
 You tread water to stay afloat. You're getting tired.  A stick of very wet driftwood, about six feet long and and one inch thick.

>get the stick
Taken.

>i
You are carrying:
  a stick

* * *

>get the stick
Taken.

>sw
Ocean Waves
 You lay on your back in the warm water as the waves lift your body up and down rythmically.  The sun's relentless heat beats down on you and the salt spray stings your eyes. The sea laps against your face and sometimes over it.  When it does, you spout like a tiny human whale.

* * *

>ne
Even More Open Water (on the piece of wood)
 A stick of very wet driftwood, about six feet long and and one inch thick.

>get the stick
You pick up the driftwood stick.

>i
You are carrying nothing.

* * *

>ne
Even More Open Water
 You tread water to stay afloat. You're getting tired.  A stick of very wet driftwood, about six feet long and and one inch thick.

>sw
Ocean Waves
 You lay on your back in the warm water as the waves lift your body up and down rythmically.  The sun's relentless heat beats down on you and the salt spray stings your eyes. The sea laps against your face and sometimes over it.  When it does, you spout like a tiny human whale.

>get on wood
You can't see any such thing.

>w
Rippling Waves
 You see a piece of wood about six feet in length. You swim over and cling to it gratefully. You look at the wood, and a chill goes through you. This is actually a board that has been roughly hewn from log.

You can see a piece of wood here.

* * *

>get on the wood
You mount the piece of wood.

>ne
Floating Object (on the piece of wood)
 A body seems to have been the source of a partial meal.

On the body is a jacket.

>get jacket
Taken.

* * *

>get stick
Taken.

>put the stick in the knothole
You place the driftwood stick into the knothole. It's a tight fit, but you manage it. Your little plank surfboard now has a mast.

>w
Floating Object (on the piece of wood)
 A body seems to have been the source of a partial meal.

>get the jacket
You already have that.

>put the jacket on the stick
You drape the jacket over the stick by the collar.
The wind catches the jacket and pulls you along over the waves.

Rushing Waves (on the piece of wood)
You rush along the tops of the waves as a westward wind blows your makeshift sail.  The sail is in the center position and the wind fills it nicely. The board is slippery and wet and hits the occasional wave just so, sending a spray into your face, almost knocking you from the board. You cling to the fragile looking stick of driftwood desperately hoping that it will hold and keep you on the board.

>w
You begin to paddle in that direction but without a plan or destination you soon lose hope and return.

>l
Journeying On The Waves (on the piece of wood)
A brisk wind wind is blowing. The sun hangs low in the sky. In the distance you can barely make out the shape of an island jutting above the waves

You can see a sail here.

>w
You begin to paddle, but it has little effect.

>l
Journeying On The Waves (on the piece of wood)
A brisk westward wind is blowing. The sun hangs low in the sky. You speed ahead toward the island as the wind catches your fancy jacket-sail.

You can see a centered positioned sail here.

>l
Journeying On The Waves (on the piece of wood)
A brisk westward wind is blowing. The sun hangs low in the sky. You speed ahead toward the island as the wind catches your fancy jacket-sail.

You can see a centered positioned sail here.

The wind suddenly shifts to the westward! You speed ahead toward the island as the wind catches your fancy jacket-sail.

>l
Journeying On The Waves (on the piece of wood)
A brisk westward wind is blowing. The sun hangs low in the sky. You speed ahead toward the island as the wind catches your fancy jacket-sail.

You can see a centered positioned sail here.

* * *

>l
Journeying On The Waves (on the piece of wood)
A brisk northwestward wind is blowing. The sun hangs low in the sky. Your speed toward the island has slowed to a crawl.

You can see a centered positioned sail here.

>l
Journeying On The Waves (on the piece of wood)
A brisk northwestward wind is blowing. The sun hangs low in the sky. Your speed toward the island has slowed to a crawl.

You can see a centered positioned sail here.

>turn sail left
You twist the mast slightly to the left.

>l
Journeying On The Waves (on the piece of wood)
A brisk northwestward wind is blowing. The sun hangs low in the sky. Your speed toward the island has slowed to a crawl.

You can see a left positioned sail here.

>turn sail right
You twist the mast slightly to the right.

The wind suddenly shifts to the northwestward! Your speed toward the island has slowed to a crawl.

>l
Journeying On The Waves (on the piece of wood)
A brisk northwestward wind is blowing. The sun hangs low in the sky. Your speed toward the island has slowed to a crawl.

You can see a centered positioned sail here.

* * *

>turn sail left
You twist the mast slightly to the left.

>l
Journeying On The Waves (on the piece of wood)
A brisk southwestward wind is blowing. The sun hangs low in the sky. You speed ahead toward the island as the wind catches your fancy jacket-sail.

You can see a left positioned sail here.

The wind suddenly shifts to the southwestward! You speed ahead toward the island as the wind catches your fancy jacket-sail.

>l
Journeying On The Waves (on the piece of wood)
A brisk southwestward wind is blowing. The sun hangs low in the sky. You speed ahead toward the island as the wind catches your fancy jacket-sail.

You can see a left positioned sail here.

The wind suddenly shifts to the southwestward! You speed ahead toward the island as the wind catches your fancy jacket-sail.

>l
Journeying On The Waves (on the piece of wood)
A brisk southwestward wind is blowing. The sun hangs low in the sky. You speed ahead toward the island as the wind catches your fancy jacket-sail.

You can see a left positioned sail here.

>l
Journeying On The Waves (on the piece of wood)
A brisk southwestward wind is blowing. The sun hangs low in the sky. You speed ahead toward the island as the wind catches your fancy jacket-sail.

You can see a left positioned sail here.

>l
Island Beach (on the piece of wood)
You are on a beautiful island beach.

* * *

>l
Rippling Waves (on the piece of wood)

>put stick in knothole
You place the driftwood stick into the knothole. It's tight fit but you manage it. Your little plank surfboard now has a mast.

>put jacket on mast
You can't see any such thing.

>put jacket on stick
You drape the jacket over the stick by the collar.
The wind catches the jacket and pulls you along over the waves.

Rushing Waves (on the piece of wood)
You rush along the tops of the waves as the wind blows your makeshift sail.  The board is slippery and wet and hits the occasional wave just so, sending a spray into your face, almost knocking you from the board. You cling to the fragile looking stick of driftwood desperately hoping that it will hold and keep you on the board.

* * *

>l
Rushing Waves (on the piece of wood)
You rush along the tops of the waves as the wind blows your makeshift sail.  The board is slippery and wet and hits the occasional wave just so, sending a spray into your face, almost knocking you from the board. You cling to the fragile looking stick of driftwood desperately hoping that it will hold and keep you on the board.

>l
Journeying On The Waves (on the piece of wood)
A brisk wind wind is blowing. The sun hangs low in the sky over a distant island. Island

You can see a sail here.

* * *

>l
Journeying On The Waves (on the piece of wood)
A brisk westward wind is blowing. The sun hangs low in the sky over a distant island. You speed ahead toward the island as the wind catches your fancy jacket-sail.

You can see a centered positioned sail here.

The wind suddenly shifts to the westward! You speed ahead toward the island as the wind catches your fancy jacket-sail.

>l
Journeying On The Waves (on the piece of wood)
A brisk westward wind is blowing. The sun hangs low in the sky over a distant island. You speed ahead toward the island as the wind catches your fancy jacket-sail.

You can see a centered positioned sail here.

The wind suddenly shifts to the westward! You speed ahead toward the island as the wind catches your fancy jacket-sail.

* * *

>turn sail left
You twist the mast slightly to the left.

The wind suddenly shifts to the southwestward! You speed ahead toward the island as the wind catches your fancy jacket-sail.

>l
Journeying On The Waves (on the piece of wood)
A brisk southwestward wind is blowing. The sun hangs low in the sky over a distant island. You speed ahead toward the island as the wind catches your fancy jacket-sail.

You can see a left positioned sail here.

>l
Journeying On The Waves (on the piece of wood)
A brisk northwestward wind is blowing. The sun hangs low in the sky over a distant island. Your speed toward the island has slowed to a crawl.

You can see a left positioned sail here.

>l
Journeying On The Waves (on the piece of wood)
A brisk northwestward wind is blowing. The sun hangs low in the sky over a distant island. Your speed toward the island has slowed to a crawl.

You can see a left positioned sail here.

The wind suddenly shifts to the northwestward! Your speed toward the island has slowed to a crawl.

>turn sail right
You twist the mast slightly to the right.

The wind suddenly shifts to the westward! You speed ahead toward the island as the wind catches your fancy jacket-sail.

* * *

>turn sail left
You twist the mast slightly to the left.

The wind suddenly shifts to the southwestward! You speed ahead toward the island as the wind catches your fancy jacket-sail.

>l
Island Beach (on the piece of wood)
You are on a beautiful island beach.

* * *

>inventory
You are carrying nothing.

>look
Even More Open Water
 You tread water to stay afloat. You're getting tired.  A stick of very wet driftwood, about six feet long and and one inch thick.

* * *

>quit
Are you sure you want to quit?

* * *

>read book
You can't see any such thing.

What next?  You can say, help, to get more information on how to play.

>read brochure
This is the brochure that you were given when you boarded the ship. There appears to be a section for what to do in the case of an emergency.

In brochure are a move page, a game page and an object page.

You deeply regret trying to stop your phone from falling over the railing of the ship. Now look what's happened.

What next?  You can say, help, to get more information on how to play.

>read move page
You see nothing special about the move page.

This really sucks. You could be kicking back right now having an ice-cold drink in the ship's lounge.

What next?  You can say, help, to get more information on how to play.

* * *

>read the brochure
This is the brochure that you were given when you boarded the ship. There appears to be a section for what to do in the case of an emergency.

In brochure are a move page, a game page and an object page.

You deeply regret trying to stop your phone from falling over the railing of the ship. Now look what's happened.

What next?  You can say, help, to get more information on how to play.

>read the move page
On your tour of the ship you can move about by saying, North, East, West, or South. You can also say, Up or Down, or Climb.

This really sucks. You could be kicking back right now having an ice-cold drink in the ship's lounge.

What next?  You can say, help, to get more information on how to play.

* * *

>read the move page
The page reads... On your tour of the ship you can move about by saying, North, East, West, or South. You can also say, Up or Down, or Climb.

You deeply regret trying to stop your phone from falling over the railing of the ship. Now look what's happened.

What next?  You can say, help, to get more information on how to play.

>l
Ocean Waves
....  You lay on your back in the warm water as your body floats up and down the rythmic waves. The hot sun beats down on you and there is not a cloud in the clear blue sky.

This really sucks. You could be kicking back right now having an ice-cold drink in the ship's lounge.

What next?  You can say, help, to get more information on how to play.

>i
You are carrying:
  brochure
    a move page
    a game page
    an object page

At least one good thing has come of all this, you won't have to worry about ending your vacation any time soon.

What next?  You can say, help, to get more information on how to play.

>l
Ocean Waves
....  You lay on your back in the warm water as your body floats up and down the rythmic waves. The hot sun beats down on you and there is not a cloud in the clear blue sky.

What next?  You can say, help, to get more information on how to play.

>l
Ocean Waves
....  You lay on your back in the warm water as your body floats up and down the rythmic waves. The hot sun beats down on you and there is not a cloud in the clear blue sky.

What next?  You can say, help, to get more information on how to play.

>l
Ocean Waves
....  You lay on your back in the warm water as your body floats up and down the rythmic waves. The hot sun beats down on you and there is not a cloud in the clear blue sky.

You're getting so tired, and the waves are kicking up some in the wind. You have to get out of the water soon.

What next?  You can say, help, to get more information on how to play.

>l
Ocean Waves
....  You lay on your back in the warm water as your body floats up and down the rythmic waves. The hot sun beats down on you and there is not a cloud in the clear blue sky.

What next?  You can say, help, to get more information on how to play.

>l
Ocean Waves
....  You lay on your back in the warm water as your body floats up and down the rythmic waves. The hot sun beats down on you and there is not a cloud in the clear blue sky.

You are suddenly exhausted, you try to resume floating on your back again, but the waves are higher now and sweep you under.  You reach for the surface as you sink into the gloom.

    *** You have drowned. ***

Would you like to RESTART, RESTORE a saved game, QUIT or UNDO the last command?

* * *

>s
More Open Water
 You tread water to stay afloat. You're getting tired.  Nothing but more water can be seen in all directions.

You must have hit your head against the ship during the fall.  A small raised lump on the back of your skull is throbbing.

>e
You can't go that way.

* * *

>e
Open Water
You tread water.  Nothing but more water can be seen.

>n
Small Floating Object
You see an human shape floating face down in the water.

* * *

>s
More Open Water
 You tread water to stay afloat. You're getting tired.  Nothing but more water can be seen in all directions.

You must have hit your head against the ship during the fall.  A small raised lump on the back of your skull is throbbing.

>n
Ocean Waves
 You lay on your back in the warm water as your body floats up and down the rythmic waves. The hot sun beats down on you and there is not a cloud in the clear blue sky. 

This really sucks. You could be kicking back having an ice-cold drink in the ship's lounge right now.

>n
Floating Object
 You tread water to stay afloat.  You're getting tired.  A body seems to have been the source of a partial meal.

On the body is a jacket.

>s
Ocean Waves
 You lay on your back in the warm water as the waves lift your body up and down rythmically.  The sun's relentless heat beats down on you and the salt spray stings your eyes. The sea laps against your face and sometimes over it.  When it does, you spout like a tiny human whale.

* * *

>e
Ocean Waves
 You lay on your back in the warm water as the waves lift your body up and down rythmically.  The sun's relentless heat beats down on you and the salt spray stings your eyes. The sea laps against your face and sometimes over it.  When it does, you spout like a tiny human whale.

>e
Open Water
 You tread water to stay afloat.  You're getting tired. If only you had something to float on. Nothing but more water can be seen.

>e
You begin to paddle in that direction but without a plan or destination you soon lose hope and return.

>w
Ocean Waves
 You lay on your back in the warm water as the waves lift your body up and down rythmically.  The sun's relentless heat beats down on you and the salt spray stings your eyes. The sea laps against your face and sometimes over it.  When it does, you spout like a tiny human whale.

* * *

>w
Rippling Waves
You cling to a piece of wood.  It seems to have been part of a boat at one time..

>ne
You begin to paddle in that direction but without a plan or destination you soon lose hope and return.

>sw
You begin to paddle in that direction but without a plan or destination you soon lose hope and return.

>se
You begin to paddle in that direction but without a plan or destination you soon lose hope and return.

>nw
You begin to paddle in that direction but without a plan or destination you soon lose hope and return.

>e
Ocean Waves
 You lay on your back in the warm water as the waves lift your body up and down rythmically.  The sun's relentless heat beats down on you and the salt spray stings your eyes. The sea laps against your face and sometimes over it.  When it does, you spout like a tiny human whale.

>nw
You begin to paddle in that direction but without a plan or destination you soon lose hope and return.

* * *

>se
You begin to paddle in that direction but without a plan or destination you soon lose hope and return.

>sw
You begin to paddle in that direction but without a plan or destination you soon lose hope and return.

>ne
Even More Open Water
A stick of very wet driftwood, about six feet long and and one inch thick.

* * *

>n
Ocean Waves
 You lay on your back in the warm water as your body floats up and down the rythmic waves. The hot sun beats down on you and there is not a cloud in the clear blue sky. 

This really sucks. You could be kicking back having an ice-cold drink in the ship's lounge right now.

>w
Rippling Waves
 You see a piece of wood about six feet in length. You swim over and cling to it gratefully. You look at the wood, and a surge of hope goes through you. This is actually a board that has been roughly hewn from a log.

You can see a piece of wood here.

Well, at least you won't have to worry about ending your vacation any time soon.

>get on the bored
Thank goodness!  You were getting exhausted just trying to stay alfloat.

You mount the piece of wood.

>e
Ocean Waves (on the piece of wood)
 The water laps at the plank you sit on, rocking you up and down.  You can see a dark object bobbing on the surface to the North.

* * *

>n
You can't sail on land. You should probably get off the board.

>get off bored
You dismount the piece of wood.

White Sand Beach
You are on a beautiful island beach. To the east there is nothing but ocean for as far as the eye can see. This white sand beach extends north and south.  To the west is a lush jungle of green vegetation.

You can see a piece of wood here.

>n
North Beach
You are on the beach a little north from where you came ashore.  You can see your sailboard to the south. The palm trees whisper in the wind to the west in the lush jungle.

You can see a Sea Turtle here.

>look at turtle
The Sea Turtle is about four feet around and has a colorful dark green shell. Her flippered legs propel her forward as she shuffles accross the beach toward a low sandy mound near the tree line to the west. She turns a large intelligent eye at you for a few seconds, but then continues laboring toward the mound.

>l
North Beach
You are on the beach a little north from where you came ashore.  You can see your sailboard to the south. The palm trees whisper in the wind to the west in the lush jungle.

You can see a Sea Turtle here.

>n
You can't go that way.

>l
North Beach
You are on the beach a little north from where you came ashore.  You can see your sailboard to the south. The palm trees whisper in the wind to the west in the lush jungle.

You can see a Sea Turtle here.

>l
North Beach
You are on the beach a little north from where you came ashore.  You can see your sailboard to the south. The palm trees whisper in the wind to the west in the lush jungle.

You can see a Sea Turtle here.

>get off board
You can't see any such thing.

>n
You can't go that way.

>look at turtle
The Sea Turtle is about four feet around and has a colorful dark green shell. Her flippered legs propel her forward as she shuffles accross the beach toward a low sandy mound near the tree line to the west. She turns a large intelligent eye at you for a few seconds, but then continues laboring toward the mound.

>examine sandy mound
You can't see any such thing.

>l
North Beach
You are on the beach a little north from where you came ashore.  You can see your sailboard to the south. The palm trees whisper in the wind to the west in the lush jungle.

You can see a Sea Turtle here.

>turn sail right
You can't see any such thing.

>l
North Beach
You are on the beach a little north from where you came ashore.  You can see your sailboard to the south. The palm trees whisper in the wind to the west in the lush jungle.

You can see a Sea Turtle here.

>turn sail left
You can't see any such thing.

>turn sail left
You can't see any such thing.

>l
North Beach
You are on the beach a little north from where you came ashore.  You can see your sailboard to the south. The palm trees whisper in the wind to the west in the lush jungle.

You can see a Sea Turtle here.

>get off wood
You can't see any such thing.

>n
You can't go that way.

* * *

>l
North Beach
You are on the beach a little north from where you came ashore.  You can see your sailboard to the south. The palm trees whisper in the wind to the west in the lush jungle.

You can see a Sea Turtle here.

>examine turtle
The Sea Turtle is about four feet around and has a colorful dark green shell. Her flippered legs propel her forward as she shuffles accross the beach toward a low sandy mound near the tree line to the west. She turns a large intelligent eye at you for a few seconds, but then continues laboring toward the mound.

>w
The Sea Turtle swivels quickly toward you, snapping its curved beak at the air inches from your exposed legs. You stagger back in fear for your life.

>hit turtle
Violence isn't the answer to this one.

>ride turtle
The Sea Turtle cannot be ridden.

I beg your pardon?

>Instead of riding the Sea Turtle, say "She cranes her neck and snaps at you. You back off quickly in fear."
You seem to want to talk to someone, but I can't see whom.

>l
North Beach
You are on the beach a little north from where you came ashore.  You can see your sailboard to the south. The palm trees whisper in the wind to the west in the lush jungle.

You can see a Sea Turtle here.

* * *

>w
Rippling Waves
 You see a piece of wood about six feet in length. You swim over and cling to it gratefully. You look at the wood, and a surge of hope goes through you. This is actually a board that has been roughly hewn from a log.

You can see a piece of wood here.

Well, at least you won't have to worry about ending your vacation any time soon.

>get on wood
Thank goodness!  You were getting exhausted just trying to stay alfloat.

You mount the piece of wood.

>e
Ocean Waves (on the piece of wood)
 The water laps at the plank you sit on, rocking you up and down.  You can see a dark object bobbing on the surface to the North.

* * *

>put stick in hole
You place the driftwood stick into the knothole. It's a tight fit, but you manage it. Your little plank surfboard now has a mast.

>put jacket on stick
You drape the jacket over the stick by the collar.
The wind catches the jacket and pulls you along over the waves.

Journeying On The Waves (on the piece of wood)
A brisk wind wind is blowing. The sun hangs low in the sky. In the distance you can barely make out the shape of an island jutting above the waves

You can see a sail here.

There is the faint outline of an island in the distance.

>l
Journeying On The Waves (on the piece of wood)
A brisk westward wind is blowing. The sun hangs low in the sky. You speed ahead toward the island as the wind catches your fancy jacket-sail.

You can see a centered positioned sail here.

There is the faint outline of an island in the distance.

* * *

>l
White Sand Beach (on the piece of wood)
You are on a beautiful island beach. To the east there is nothing but ocean for as far as the eye can see. This white sand beach extends north and south.  To the west is a lush jungle of green vegetation.

>s
You can't sail on land. You should probably get off the board.

>get off bored
You dismount the piece of wood.

White Sand Beach
You are on a beautiful island beach. To the east there is nothing but ocean for as far as the eye can see. This white sand beach extends north and south.  To the west is a lush jungle of green vegetation.

You can see a piece of wood here.

>look at wood
It's a sturdy plank with round knothole in the middle of it.

>look in bored
There is nothing on the piece of wood.

>look in hole
In the knothole is a stick.

>look at stick
On the stick is a jacket.

* * *

>se
You begin to paddle in that direction but without a plan or destination you soon lose hope and return.

>ne
Even More Open Water
A stick of very wet driftwood, about six feet long and and one inch thick.

>w
You begin to paddle in that direction but without a plan or destination you soon lose hope and return.

>ne
You begin to paddle in that direction but without a plan or destination you soon lose hope and return.

* * *

>s
You begin to paddle in that direction but without a plan or destination you soon lose hope and return.

>se
You begin to paddle in that direction but without a plan or destination you soon lose hope and return.

* * *

>sw
Ocean Waves
 You lay on your back in the warm water as the waves lift your body up and down rythmically.  The sun's relentless heat beats down on you and the salt spray stings your eyes. The sea laps against your face and sometimes over it.  When it does, you spout like a tiny human whale.

>e
Open Water
 You tread water to stay afloat.  You're getting tired. Nothing but more water can be seen.

>e
You begin to paddle in that direction but without a plan or destination you soon lose hope and return.

* * *

>s
You begin to paddle in that direction but without a plan or destination you soon lose hope and return.

>w
Ocean Waves
 You lay on your back in the warm water as the waves lift your body up and down rythmically.  The sun's relentless heat beats down on you and the salt spray stings your eyes. The sea laps against your face and sometimes over it.  When it does, you spout like a tiny human whale.

* * *

>w
Rippling Waves
You cling to a piece of wood.  It seems to have been part of a boat at one time..

>s
You begin to paddle in that direction but without a plan or destination you soon lose hope and return.

* * *

>s
More Open Water
 You tread water to stay afloat.  You're getting tired.  Nothing but more water can be seen.

>ne
You begin to paddle in that direction but without a plan or destination you soon lose hope and return.

* * *

>e
You begin to paddle in that direction but without a plan or destination you soon lose hope and return.

>n
Ocean Waves
 You lay on your back in the warm water as the waves lift your body up and down rythmically.  The sun's relentless heat beats down on you and the salt spray stings your eyes. The sea laps against your face and sometimes over it.  When it does, you spout like a tiny human whale.

* * *

>e
Ocean Waves (on the piece of wood)
 The water laps at the plank you sit on, rocking you up and down.

>ne
Even More Open Water (on the piece of wood)
A stick of very wet driftwood, about six feet long and and one inch thick.

* * *

>put stick in knothole
You place the driftwood stick into the knothole. It's tight fit but you manage it. Your little plank surfboard now has a mast.

>put jacket on stick
You drape the jacket over the stick by the collar.
The wind catches the jacket and pulls you along over the waves.

>turn stick
Nothing obvious happens.

>turn stick counter clockwise
I only understood you as far as wanting to turn the stick.

>turn stick counter-clockwise
I only understood you as far as wanting to turn the stick.

>l
Rushing Waves (on the piece of wood)
You rush along the tops of the waves as the wind blows your makeshift sail.  The board is slippery and wet and hits the occasional wave just so, sending a spray into your face, almost knocking you from the board. You cling to the fragile looking stick of driftwood desperately hoping that it will hold and keep you on the board.

>get on board
You are already riding the piece of wood.

>get on board
You are already riding the piece of wood.

>restart
Are you sure you want to restart?

* * *

>get stick
Taken.

>put stick in wood
That can't contain things.

>put stick in knothole
You place the driftwood stick into the knothole. It's tight fit but you manage it. Your little plank surfboard now has a mast.

>sw
Ocean Waves (on the piece of wood)
 The water laps at the plank you sit on, rocking you up and down.

>n
Floating Object (on the piece of wood)
A body seems to have been the source of a partial meal.

On the body is a jacket.

* * *

>get jacket
Taken.

>put jacket on stick
You drape the jacket over the stick by the collar.
The wind catches the jacket and pulls you along over the waves.

>l
Rushing Waves (on the piece of wood)
You rush along the tops of the waves as the wind blows your makeshift sail.  The board is slippery and wet and hits the occasional wave just so, sending a spray into your face, almost knocking you from the board. You cling to the fragile looking stick of driftwood desperately hoping that it will hold and keep you on the board.

>i
You are carrying nothing.

>l
Rushing Waves (on the piece of wood)
You rush along the tops of the waves as the wind blows your makeshift sail.  The board is slippery and wet and hits the occasional wave just so, sending a spray into your face, almost knocking you from the board. You cling to the fragile looking stick of driftwood desperately hoping that it will hold and keep you on the board.

>look at wood
It's a sturdy plank of the type used to make wooden hulls. There is a small knothole in the middle of it.

>get on wood
You are already riding the piece of wood.

>get on plank
You are already riding the piece of wood.

>l
Rushing Waves (on the piece of wood)
You rush along the tops of the waves as the wind blows your makeshift sail.  The board is slippery and wet and hits the occasional wave just so, sending a spray into your face, almost knocking you from the board. You cling to the fragile looking stick of driftwood desperately hoping that it will hold and keep you on the board.

* * *

>i
You are carrying nothing.

>look at board
It's a sturdy plank of the type used to make wooden hulls. There is a small knothole in the middle of it.

>look in knothole
In the knothole is a stick.

>look at stick
On the stick is a jacket.

* * *

>tack left
That's not a verb I recognise.

>examine tack
You can't see any such thing.

* * *

>test me
>--> No test scripts exist for this game.
What next?  You can say, help, to get more information on how to play.

>get bug
Rippling Waves (on the piece of wood)
....  You are sitting on a rough board about six feet in length. All around you is ocean and sky.

White Sand Beach
.... You are on a beautiful island beach. To the east there is nothing but ocean for as far as the eye can see. The beach extends north and south.  To the west is a lush jungle of green vegetation.

You can see a stick, a jacket, a piece of wood and a palm tree here.

You can't reach into Rippling Waves.

Your stomach aches with hunger. You better find something to eat soon.

What next?  You can say, help, to get more information on how to play.

* * *

>twist jacket
You can't see any such thing.

>n
Floating Object
A body seems to have been the source of a partial meal.

On the body is a jacket.

* * *

>get jacket
Taken.

>twist jacket
Nothing obvious happens.

* * *

>w
Rippling Waves
....  You see a piece of wood about six feet in length. You swim over and cling to it gratefully. You look at the wood, and a surge of hope goes through you. This is actually a wide board that has been roughly hewn from a log.

You can see a piece of wood here.

You deeply regret trying to stop your phone from falling over the railing of the ship. Now look what's happened.

What next?  You can say, help, to get more information on how to play.

>e
Ocean Waves
 You lay on your back in the warm water as the waves lift your body up and down rythmically.  The sun's relentless heat beats down on you and the salt spray stings your eyes. The sea laps against your face and sometimes over it.  When it does, you spout like a tiny human whale.

>e
Open Water
Nothing but more water can be seen.

* * *

>e
Ocean Waves
 You lay on your back in the warm water as the waves lift your body up and down rythmically.  The sun's relentless heat beats down on you and the salt spray stings your eyes. The sea laps against your face and sometimes over it.  When it does, you spout like a tiny human whale.

>n
Floating Object
 You tread water to stay afloat. You're getting tired.  A body seems to have been the source of a partial meal.

On the body is a jacket.

>get jacket
You can't hold the jacket and swim.

>s
Ocean Waves
 You lay on your back in the warm water as the waves lift your body up and down rythmically.  The sun's relentless heat beats down on you and the salt spray stings your eyes. The sea laps against your face and sometimes over it.  When it does, you spout like a tiny human whale.

* * *

>get jacket
You can't hold the jacket and swim.

>ss
That's not a verb I recognise.

>s
Ocean Waves
 You lay on your back in the warm water as the waves lift your body up and down rythmically.  The sun's relentless heat beats down on you and the salt spray stings your eyes. The sea laps against your face and sometimes over it.  When it does, you spout like a tiny human whale.

* * *

>e
Open Water
 You tread water to stay afloat. You're getting tired. If only you had something to float on. Nothing but more water can be seen.

>w
Ocean Waves
 You lay on your back in the warm water as the waves lift your body up and down rythmically.  The sun's relentless heat beats down on you and the salt spray stings your eyes. The sea laps against your face and sometimes over it.  When it does, you spout like a tiny human whale.

>ne
Even More Open Water
 You tread water to stay afloat. You're getting tired.  A stick of very wet driftwood, about six feet long and and one inch thick.

>get sitck
You can't see any such thing.

>get the stick
You can't hold the stick and swim.

>w
You begin to paddle in that direction but without a plan or destination you soon lose hope and return.

* * *

>n
Floating Object (on the piece of wood)
 A body seems to have been the source of a partial meal.

On the body is a jacket.

>put the stick into the wood
That can't contain things.

>put the stick into the hole
You can't see any such thing.

>put the stick into the knothole
You place the driftwood stick into the knothole. It's a tight fit, but you manage it. Your little plank surfboard now has a mast.

>put the jacket onto the stick
(first taking the jacket)
You drape the jacket over the stick by the collar.
The wind catches the jacket and pulls you along over the waves.

Rushing Waves (on the piece of wood)
You rush along the tops of the waves as the wind blows your makeshift sail. The board is slippery and wet and hits the occasional wave just so, sending a spray into your face, almost knocking you from the board. You cling to the fragile looking stick of driftwood desperately hoping that it will hold and keep you on the board.

>examine the jacket
It's an olive-drav green military fatigue jacket with an over sized pocket.

>examine pockets
You can't see any such thing.

>get a knife
You can't see any such thing.

>look at the pockets
You can't see any such thing.

>look at the pocket
You can't see any such thing.

>i
You are carrying nothing.

>l
Rushing Waves (on the piece of wood)
You rush along the tops of the waves as the wind blows your makeshift sail. The board is slippery and wet and hits the occasional wave just so, sending a spray into your face, almost knocking you from the board. You cling to the fragile looking stick of driftwood desperately hoping that it will hold and keep you on the board.

>restart
Are you sure you want to restart?

>y
You were a lowly ensign serving aboard the starship Venture when suddenly the alarm sounded.  You felt the ship lurch and buck while you ran to the nearest escape pod, but something went horribly wrong.  Before you could safely strap into your acceleration couch, a large explosion cast you about the pod and you hit your head hard. The last thing you remember is hearing frantic pleas for help over the radio.  Unkown hours later you regain consciousness, floating in the middle of a tropical ocean on an alien world.

Alien Shores
An Interactive Fiction by Keith B Phillips
Release 1 / Serial number 180903 / Inform 7 build 6M62 (I6/v6.33 lib 6/12N) SD

Ocean Waves
 You lay on your back in the warm water as the waves lift your body up and down rythmically.  The sun's relentless heat beats down on you and the salt spray stings your eyes. The sea laps against your face and sometimes over it.  When it does, you spout like a tiny human whale.

>n
Floating Object
 You tread water to stay afloat. You're getting tired.  A body seems to have been the source of a partial meal.

On the body is a jacket.

>look in pocket
You can't see any such thing.

>get knife
You can't see any such thing.

>look in pockets
You can't see any such thing.

>look in pocket
You can't see any such thing.

>look at jacket
It's an olive-drav green military fatigue jacket with an over sized pocket.

>examine pocket
You can't see any such thing.

>examine pockets
You can't see any such thing.

* * *

>e
Ocean Waves
 You lay on your back in the warm water as the waves lift your body up and down rythmically.  The sun's relentless heat beats down on you and the salt spray stings your eyes. The sea laps against your face and sometimes over it.  When it does, you spout like a tiny human whale.

>w
Rippling Waves
You cling to a piece of wood.  It seems to have been part of a boat at one time..

* * *

>n
Floating Object (on the piece of wood)
A body seems to have been the source of a partial meal.

On the body is a jacket.

>s
Ocean Waves (on the piece of wood)
 The water laps at the plank you sit on, rocking you up and down.

>w
Rippling Waves (on the piece of wood)

>get off wood
You dismount the piece of wood.

Rippling Waves
You cling to a piece of wood.  It seems to have been part of a boat at one time..

* * *

>w
Rippling Waves
....  You see a piece of wood about six feet in length. You swim over and cling to it gratefully. You look at the wood, and a surge of hope goes through you. This is actually a wide board that has been roughly hewn from a log.

You can see a piece of wood here.

You deeply regret trying to stop your phone from falling over the railing of the ship. Now look what's happened.

What next?  You can say, help, to get more information on how to play.

>examine wood
It's a sturdy plank of the type used to make wooden hulls. There is a small knothole in the middle of it.

>get on wood
You mount the piece of wood.

>e
Ocean Waves (on the piece of wood)
You lay on your back in the warm salt water as the waves lift your body up and down rythmically.

>w
Rippling Waves (on the piece of wood)

>e
Ocean Waves (on the piece of wood)
You lay on your back in the warm salt water as the waves lift your body up and down rythmically.

>e
Open Water (on the piece of wood)
 Nothing but more water can be seen.

>w
Ocean Waves (on the piece of wood)
You lay on your back in the warm salt water as the waves lift your body up and down rythmically.

>s
More Open Water (on the piece of wood)
 Nothing but more water can be seen.

>n
Ocean Waves (on the piece of wood)
You lay on your back in the warm salt water as the waves lift your body up and down rythmically.

>get off wood
You dismount the piece of wood.

Ocean Waves
You lay on your back in the warm salt water as the waves lift your body up and down rythmically.   

You cling to a piece of wood.  It seems to have been part of a boat at one time.

>l
Ocean Waves
You lay on your back in the warm salt water as the waves lift your body up and down rythmically.   

You cling to a piece of wood.  It seems to have been part of a boat at one time.

* * *

>examine wood
It's a sturdy plank of the type used to make wooden hulls. There is a small knothole in the middle of it.

>w
You can't go that way.

>get on wood
You mount the piece of wood.

* * *

>get jacket
Taken.

>s
Ocean Waves (on the piece of wood)
 The water laps at the plank you sit on, rocking you up and down.

>s
More Open Water (on the piece of wood)
 Nothing but more water can be seen.

* * *

>n
Ocean Waves (on the piece of wood)
 The water laps at the plank you sit on, rocking you up and down.

>e
Open Water (on the piece of wood)
 Nothing but more water can be seen.

* * *

>w
Ocean Waves (on the piece of wood)
 The water laps at the plank you sit on, rocking you up and down.

>ne
Even More Open Water (on the piece of wood)
A piece of very wet driftwood, about six feet long and and one inch thick.

* * *

>put stick in knothole
You put the stick into the knothole.

>examine knothole
In the knothole is a stick.

>put the jacket on the stick
You put the jacket on the stick.

>l
Even More Open Water (on the piece of wood)

* * *

>w
Rippling Waves
....  You see a piece of wood about six feet in length. You swim over and cling to it gratefully. You look at the wood, and a surge of hope goes through you. This is actually a wide board that has been roughly hewn from a log.

You can see a piece of wood here.

You deeply regret trying to stop your phone from falling over the railing of the ship. Now look what's happened.

What next?  You can say, help, to get more information on how to play.

>get board
You can't see any such thing.

>get wood
That's fixed in place.

* * *

>s
Ocean Waves (on the piece of wood)
 The water laps at the plank you sit on, rocking you up and down.

>ne
Even More Open Water (on the piece of wood)
A piece of very wet driftwood, about six feet long and and one inch thick.

* * *

>sw
Ocean Waves (on the piece of wood)
 The water laps at the plank you sit on, rocking you up and down.

>e
Open Water (on the piece of wood)
 Nothing but more water can be seen.

* * *

>n
Ocean Waves (on the piece of wood)
 The water laps at the plank you sit on, rocking you up and down.

>examine wood
It's a sturdy plank of the type used to make wooden hulls. There is a small knothole in the middle of it.

>put stick in wood
That can't contain things.

* * *

>put jacket on stick
You put the jacket on the stick.

>l
Ocean Waves (on the piece of wood)
 The water laps at the plank you sit on, rocking you up and down.

>actions
Actions listing on.

>get jacket
[taking the jacket]
Taken.
[taking the jacket - succeeded]

>get stick
[taking the stick]
Taken.
[taking the stick - succeeded]

>put stick on knothole
[putting the stick on the knothole]
Putting things on the knothole would achieve nothing.
[putting the stick on the knothole - failed the can't put onto what's not a supporter rule]

>put stick in knothole
[inserting the stick into the knothole]
[inserting the stick into the knothole - succeeded]

* * *

>w
Rippling Waves
....  You see a piece of wood about six feet in length. You swim over and cling to it gratefully. You look at the wood, and a surge of hope goes through you. This is actually a wide board that has been roughly hewn from a log.

You can see a piece of wood here.

You deeply regret trying to stop your phone from falling over the railing of the ship. Now look what's happened.

What next?  You can say, help, to get more information on how to play.

>get on board
Thank goodness!  You were getting exhausted just trying to stay alfloat.

You mount the piece of wood.

* * *

>e
Ocean Waves (on the piece of wood)
 The water laps at the plank you sit on, rocking you up and down.  You can see a dark object bobbing on the surface to the North.

>n
Glittering Waves (on the piece of wood)
 What is left of a human body floats on the surface here.  Something has been eating on it.

On the body is a jacket.

>get jacket
The body is badly decayed. You can't tell if it was male or female.  Your stomach churns from the smell, but you grit your teeth and strip the jacket off.

* * *

>get jacket
You already have that.

>get sitck
You can't see any such thing.

>put stick in hole
(first taking the stick)
You place the driftwood stick into the knothole. It's a tight fit, but you manage it. Your little plank surfboard now has a mast.

>put jacket on stick
You drape the jacket over the stick by the collar.
The wind catches the jacket and pulls you along over the waves.

Journeying On The Waves (on the piece of wood)
A brisk wind is blowing and the sun hangs low in the sky. In the distance you can barely make out the shape of an island jutting above the waves

You can see a sail here.

There is the faint outline of an island in the distance.

>w
You begin to paddle, but it has little effect. Better stick to sailing. You watch the wind pushing the sail to see if you need to turn it.

There is the faint outline of an island in the distance.

>l
Journeying On The Waves (on the piece of wood)
A brisk westward wind is blowing and the sun hangs low in the sky. You speed ahead toward the island as the wind catches your fancy jacket-sail.

You can see a centered positioned sail here.

A westward wind continues to blow. You speed ahead toward the island as the wind catches your fancy jacket-sail.

>l
Journeying On The Waves (on the piece of wood)
A brisk westward wind is blowing and the sun hangs low in the sky. You speed ahead toward the island as the wind catches your fancy jacket-sail.

You can see a centered positioned sail here.

>l
Journeying On The Waves (on the piece of wood)
A brisk northwestward wind is blowing and the sun hangs low in the sky. Your speed toward the island has slowed to a crawl.

You can see a centered positioned sail here.

>l
Journeying On The Waves (on the piece of wood)
A brisk northwestward wind is blowing and the sun hangs low in the sky. Your speed toward the island has slowed to a crawl.

You can see a centered positioned sail here.

>l
Journeying On The Waves (on the piece of wood)
A brisk northwestward wind is blowing and the sun hangs low in the sky. Your speed toward the island has slowed to a crawl.

You can see a centered positioned sail here.

The wind suddenly shifts to a northwestward wind! Your speed toward the island has slowed to a crawl.

>lturn sail left
That's not a verb I recognise.

>turn sail left
You twist the mast slightly to the left.
centered positioned sail
The island is getting closer.

>l
Journeying On The Waves (on the piece of wood)
A brisk northwestward wind is blowing and the sun hangs low in the sky. You speed ahead toward the island as the wind catches your fancy jacket-sail.

You can see a right positioned sail here.

The island is getting closer.

>l
Journeying On The Waves (on the piece of wood)
A brisk northwestward wind is blowing and the sun hangs low in the sky. You speed ahead toward the island as the wind catches your fancy jacket-sail.

You can see a right positioned sail here.

>l
Journeying On The Waves (on the piece of wood)
A brisk northwestward wind is blowing and the sun hangs low in the sky. You speed ahead toward the island as the wind catches your fancy jacket-sail.

You can see a right positioned sail here.

You've almost made it to the island.

>l
Journeying On The Waves (on the piece of wood)
A brisk northwestward wind is blowing and the sun hangs low in the sky. You speed ahead toward the island as the wind catches your fancy jacket-sail.

You can see a right positioned sail here.

You've almost made it to the island.

>restart
Are you sure you want to restart?

>y
You are floating in the middle of a tropical ocean.  You hoped that the cruise ship would notice you were missing, but it's been hours and hours, and no ship has appeared on the horizon. You deeply regret trying to stop your phone from falling over the railing of the ship.  Now look what's happened.

Alien Shores
An Interactive Fiction by Keith B Phillips
Release 1 / Serial number 180909 / Inform 7 build 6M62 (I6/v6.33 lib 6/12N) SD

Ocean Waves
 You lay on your back in the warm water as your body floats up and down the rythmic waves. The hot sun beats down on you and there is not a cloud in the clear blue sky.

>l
Ocean Waves
 You lay on your back in the warm water as your body floats up and down the rythmic waves. The hot sun beats down on you and there is not a cloud in the clear blue sky. 

You must have hit your head against the ship during the fall.  A small raised lump on the back of your skull is throbbing.

>w
Rippling Waves
 You see a piece of wood about six feet in length. You swim over and cling to it gratefully. You look at the wood, and a surge of hope goes through you. This is actually a wide board that has been roughly hewn from a log.

You can see a piece of wood here.

This really sucks. You could be kicking back having an ice-cold drink in the ship's lounge right now.

>get on wood
Thank goodness!  You were getting exhausted just trying to stay alfloat.

You mount the piece of wood.

>ne
Glittering Waves (on the piece of wood)
 What is left of a human body floats on the surface here.  Something has been eating on it.

On the body is a jacket.

>get all
jacket: The body is badly decayed. You can't tell if it was male or female.  Your stomach churns from the smell, but you grit your teeth and strip the jacket off.
knife: Taken.

>e
Even More Open Water (on the piece of wood)
 There is a stick of very wet driftwood here, about six feet long and and one inch thick.

>get all
stick: You're carrying too many things already.

>put knife in pocket
You put the knife into pocket.

>get stick
Taken.

* * *

>put stick in hole
You place the driftwood stick into the knothole. It's a tight fit, but you manage it. Your little plank surfboard now has a mast.

>put jacket on stick
You drape the jacket over the stick by the collar.
The wind catches the jacket and pulls you along over the waves.

Journeying On The Waves (on the piece of wood)
A brisk wind is blowing and the sun hangs low in the sky. In the distance you can barely make out the shape of an island jutting above the waves

You can see a sail here.

There is the faint outline of an island in the distance.

* * *

>w
You begin to paddle, but it has little effect. Better stick to sailing. You watch the wind pushing the sail to see if you need to turn it.

There is the faint outline of an island in the distance.

>l
Journeying On The Waves (on the piece of wood)
A brisk westward wind is blowing and the sun hangs low in the sky. You speed ahead toward the island as the wind catches your fancy jacket-sail.

You can see a centered positioned sail here.

>l
Journeying On The Waves (on the piece of wood)
A brisk westward wind is blowing and the sun hangs low in the sky. You speed ahead toward the island as the wind catches your fancy jacket-sail.

You can see a centered positioned sail here.

The island is getting closer.

>l
Journeying On The Waves (on the piece of wood)
A brisk westward wind is blowing and the sun hangs low in the sky. You speed ahead toward the island as the wind catches your fancy jacket-sail.

You can see a centered positioned sail here.

The island is getting closer.

>l
Journeying On The Waves (on the piece of wood)
A brisk westward wind is blowing and the sun hangs low in the sky. You speed ahead toward the island as the wind catches your fancy jacket-sail.

You can see a centered positioned sail here.

>turn sail right
You twist the mast slightly to the right.
centered positioned sail

>l
Journeying On The Waves (on the piece of wood)
A brisk westward wind is blowing and the sun hangs low in the sky. Your speed toward the island has slowed to a crawl.

You can see a left positioned sail here.

A westward wind continues to blow. Your speed toward the island has slowed to a crawl.

>turn sail left
You twist the mast slightly to the left.
left positioned sail

>l
Journeying On The Waves (on the piece of wood)
A brisk southwestward wind is blowing and the sun hangs low in the sky. Your speed toward the island has slowed to a crawl.

You can see a centered positioned sail here.

>l
Journeying On The Waves (on the piece of wood)
A brisk southwestward wind is blowing and the sun hangs low in the sky. Your speed toward the island has slowed to a crawl.

You can see a centered positioned sail here.

>restart
Are you sure you want to restart?

* * *

>w
Rippling Waves
 You see a piece of wood about six feet in length. You swim over and cling to it gratefully. You look at the wood, and a surge of hope goes through you. This is actually a wide board that has been roughly hewn from a log.

You can see a piece of wood here.

You must have hit your head against the ship during the fall.  A small raised lump on the back of your skull is throbbing.

>get on wood
Thank goodness!  You were getting exhausted just trying to stay alfloat.

You mount the piece of wood.

* * *

>e
Even More Open Water (on the piece of wood)
 There is a stick of very wet driftwood here, about six feet long and and one inch thick.

>get all
stick: Taken.

>put stick in hole
You place the driftwood stick into the knothole. It's a tight fit, but you manage it. Your little plank surfboard now has a mast.

* * *

>put jacket on stick
You drape the jacket over the stick by the collar.
The wind catches the jacket and pulls you along over the waves.

Journeying On The Waves (on the piece of wood)
A brisk wind is blowing and the sun hangs low in the sky. In the distance you can barely make out the shape of an island jutting above the waves

You can see a sail here.

There is the faint outline of an island in the distance.

>l
Journeying On The Waves (on the piece of wood)
A brisk westward wind is blowing and the sun hangs low in the sky. You speed ahead toward the island as the wind catches your fancy jacket-sail.

You can see a centered positioned sail here.

There is the faint outline of an island in the distance.

>l
Journeying On The Waves (on the piece of wood)
A brisk westward wind is blowing and the sun hangs low in the sky. You speed ahead toward the island as the wind catches your fancy jacket-sail.

You can see a centered positioned sail here.

* * *

>turn sail right
You twist the mast slightly to the right.
centered positioned sail

>l
Journeying On The Waves (on the piece of wood)
A brisk westward wind is blowing and the sun hangs low in the sky. Your speed toward the island has slowed to a crawl.

You can see a left positioned sail here.

>turn sail left
You twist the mast slightly to the left.
left positioned sail
A westward wind continues to blow. You speed ahead toward the island as the wind catches your fancy jacket-sail.You've almost made it to the island.

>l
Journeying On The Waves (on the piece of wood)
A brisk westward wind is blowing and the sun hangs low in the sky. You speed ahead toward the island as the wind catches your fancy jacket-sail.

You can see a centered positioned sail here.

You've almost made it to the island.

>l
Journeying On The Waves (on the piece of wood)
A brisk southwestward wind is blowing and the sun hangs low in the sky. Your speed toward the island has slowed to a crawl.

You can see a centered positioned sail here.

You've almost made it to the island.

>turn sail right
You twist the mast slightly to the right.
centered positioned sail
You've almost made it to the island.

>l
Journeying On The Waves (on the piece of wood)
A brisk southwestward wind is blowing and the sun hangs low in the sky. You speed ahead toward the island as the wind catches your fancy jacket-sail.

You can see a left positioned sail here.

You've almost made it to the island.

>l
Journeying On The Waves (on the piece of wood)
A brisk southwestward wind is blowing and the sun hangs low in the sky. You speed ahead toward the island as the wind catches your fancy jacket-sail.

You can see a left positioned sail here.

>l
White Sand Beach (on the piece of wood)
You are on a beautiful island beach. To the east there is nothing but ocean for as far as the eye can see. This white sand beach extends north and south.  To the west is a lush jungle of green vegetation.

>restart
Are you sure you want to restart?

* * *

>put stick in hole
You place the driftwood stick into the knothole. It's a tight fit, but you manage it. Your little plank surfboard now has a mast.

>put jacket on stick
You drape the jacket over the stick by the collar.
The wind catches the jacket and pulls you along over the waves.

Journeying On The Waves (on the piece of wood)
A brisk wind is blowing and the sun hangs low in the sky. In the distance you can barely make out the shape of an island jutting above the waves

You can see a sail here.

The wind suddenly shifts to a westward wind! You speed ahead toward the island as the wind catches your fancy jacket-sail.There is the faint outline of an island in the distance.

>l
Journeying On The Waves (on the piece of wood)
A brisk westward wind is blowing and the sun hangs low in the sky. You speed ahead toward the island as the wind catches your fancy jacket-sail.

You can see a centered positioned sail here.

There is the faint outline of an island in the distance.

* * *

>l
Journeying On The Waves (on the piece of wood)
A brisk westward wind is blowing and the sun hangs low in the sky. You speed ahead toward the island as the wind catches your fancy jacket-sail.

You can see a centered positioned sail here.

>l
Journeying On The Waves (on the piece of wood)
A brisk westward wind is blowing and the sun hangs low in the sky. You speed ahead toward the island as the wind catches your fancy jacket-sail.

You can see a centered positioned sail here.

A westward wind continues to blow. You speed ahead toward the island as the wind catches your fancy jacket-sail.You've almost made it to the island.

>l
Journeying On The Waves (on the piece of wood)
A brisk westward wind is blowing and the sun hangs low in the sky. You speed ahead toward the island as the wind catches your fancy jacket-sail.

You can see a centered positioned sail here.

You've almost made it to the island.

>l
Journeying On The Waves (on the piece of wood)
A brisk northwestward wind is blowing and the sun hangs low in the sky. Your speed toward the island has slowed to a crawl.

You can see a centered positioned sail here.

You've almost made it to the island.

>turn sail left
You twist the mast slightly to the left.
centered positioned sail
You've almost made it to the island.

>l
Journeying On The Waves (on the piece of wood)
A brisk northwestward wind is blowing and the sun hangs low in the sky. You speed ahead toward the island as the wind catches your fancy jacket-sail.

You can see a right positioned sail here.

You've almost made it to the island.

>l
Journeying On The Waves (on the piece of wood)
A brisk northwestward wind is blowing and the sun hangs low in the sky. You speed ahead toward the island as the wind catches your fancy jacket-sail.

You can see a right positioned sail here.

>l
White Sand Beach (on the piece of wood)
You are on a beautiful island beach. To the east there is nothing but ocean for as far as the eye can see. This white sand beach extends north and south.  To the west is a lush jungle of green vegetation.

* * *

>get on board
Thank goodness!  You were getting exhausted just trying to stay alfloat.

You mount the piece of wood.

>ne
Floating Object (on the piece of wood)
 A body seems to have been the source of a partial meal.

On the body is a jacket.

* * *

>e
Even More Open Water (on the piece of wood)
 A stick of very wet driftwood, about six feet long and and one inch thick.

>get all
stick: Taken.

* * *

>l
Rushing Waves (on the piece of wood)
You rush along the tops of the waves as a westward wind blows your makeshift sail.  The sail is in the center position and the wind fills it nicely. The board is slippery and wet and hits the occasional wave just so, sending a spray into your face, almost knocking you from the board. You cling to the fragile looking stick of driftwood desperately hoping that it will hold and keep you on the board.

>w
You begin to paddle, but it has little effect. Better stick to sailing.

The wind suddenly shifts to the westward! You speed ahead toward the island as the wind catches your fancy jacket-sail.There is the faint outline of an island in the distance.

>l
Journeying On The Waves (on the piece of wood)
A brisk westward wind is blowing. The sun hangs low in the sky. You speed ahead toward the island as the wind catches your fancy jacket-sail.

You can see a centered positioned sail here.

There is the faint outline of an island in the distance.

>l
Journeying On The Waves (on the piece of wood)
A brisk northwestward wind is blowing. The sun hangs low in the sky. Your speed toward the island has slowed to a crawl.

You can see a centered positioned sail here.

There is the faint outline of an island in the distance.

>l
Journeying On The Waves (on the piece of wood)
A brisk northwestward wind is blowing. The sun hangs low in the sky. Your speed toward the island has slowed to a crawl.

You can see a centered positioned sail here.

There is the faint outline of an island in the distance.

>l
Journeying On The Waves (on the piece of wood)
A brisk northwestward wind is blowing. The sun hangs low in the sky. Your speed toward the island has slowed to a crawl.

You can see a centered positioned sail here.

The wind suddenly shifts to the northwestward! Your speed toward the island has slowed to a crawl.There is the faint outline of an island in the distance.

>l
Journeying On The Waves (on the piece of wood)
A brisk northwestward wind is blowing. The sun hangs low in the sky. Your speed toward the island has slowed to a crawl.

You can see a centered positioned sail here.

There is the faint outline of an island in the distance.

>l
Journeying On The Waves (on the piece of wood)
A brisk southwestward wind is blowing. The sun hangs low in the sky. Your speed toward the island has slowed to a crawl.

You can see a centered positioned sail here.

The wind suddenly shifts to the southwestward! Your speed toward the island has slowed to a crawl.There is the faint outline of an island in the distance.

>l
Journeying On The Waves (on the piece of wood)
A brisk southwestward wind is blowing. The sun hangs low in the sky. Your speed toward the island has slowed to a crawl.

You can see a centered positioned sail here.

The wind suddenly shifts to the westward! You speed ahead toward the island as the wind catches your fancy jacket-sail.There is the faint outline of an island in the distance.

>l
Journeying On The Waves (on the piece of wood)
A brisk westward wind is blowing. The sun hangs low in the sky. You speed ahead toward the island as the wind catches your fancy jacket-sail.

You can see a centered positioned sail here.

The wind suddenly shifts to the westward! You speed ahead toward the island as the wind catches your fancy jacket-sail.
A grey fin emerges from the waves.  Your adrenaline kicks in, but you manage to hold yourself together.  You guide your make-shift sailboard away from it until the fin submerges.

>l
Journeying On The Waves (on the piece of wood)
A brisk westward wind is blowing. The sun hangs low in the sky. You speed ahead toward the island as the wind catches your fancy jacket-sail.

You can see a centered positioned sail here.

The wind suddenly shifts to the northwestward! Your speed toward the island has slowed to a crawl.
A grey fin emerges from the waves.  Your adrenaline kicks in, but you manage to hold yourself together.  You guide your make-shift sailboard away from it until the fin submerges.

>l
Journeying On The Waves (on the piece of wood)
A brisk northwestward wind is blowing. The sun hangs low in the sky. Your speed toward the island has slowed to a crawl.

You can see a centered positioned sail here.

The wind suddenly shifts to the southwestward! Your speed toward the island has slowed to a crawl.
A grey fin emerges from the waves.  Your adrenaline kicks in, but you manage to hold yourself together.  You guide your make-shift sailboard away from it until the fin submerges.

>l
Journeying On The Waves (on the piece of wood)
A brisk southwestward wind is blowing. The sun hangs low in the sky. Your speed toward the island has slowed to a crawl.

You can see a centered positioned sail here.

The wind suddenly shifts to the northwestward! Your speed toward the island has slowed to a crawl.
A grey fin emerges from the waves.  Your adrenaline kicks in, but you manage to hold yourself together.  You guide your make-shift sailboard away from it until the fin submerges.

>turn sail right
You twist the mast slightly to the right.
centered positioned sail
The island is getting closer.

A grey fin emerges from the waves.  Your adrenaline kicks in, but you manage to hold yourself together.  You guide your make-shift sailboard away from it until the fin submerges.
The shark is too quick.  Eons of evolution has turned it into the perfect predator.  It smells your fear and in the blink of an eye it's over.

    *** You have been eaten. ***

Would you like to RESTART, RESTORE a saved game, QUIT or UNDO the last command?

* * *

>w
Rippling Waves
....  You see a piece of wood about six feet in length. You swim over and cling to it gratefully. You look at the wood, and a surge of hope goes through you. This is actually a wide board that has been roughly hewn from a log.

You can see a piece of wood here.

You deeply regret trying to stop your phone from falling over the railing of the ship. Now look what's happened.

What next?  You can say, help, to get more information on how to play.

>get on bored
Thank goodness!  You were getting exhausted just trying to stay alfloat.

You mount the piece of wood.

>e
Ocean Waves (on the piece of wood)
 The water laps at the plank you sit on, rocking you up and down.  You can see a dark object bobbing on the surface to the North.

* * *

>put jacket on stick
You drape the jacket over the stick by the collar.
The wind catches the jacket and pulls you along over the waves.

Journeying On The Waves (on the piece of wood)
A brisk wind wind is blowing. The sun hangs low in the sky. In the distance you can barely make out the shape of an island jutting above the waves

You can see a sail here.

There is the faint outline of an island in the distance.

>s
You begin to paddle, but it has little effect. Better stick to sailing.

There is the faint outline of an island in the distance.

>w
You can't go that way.

>n
You can't sail on land. You should probably get off the board.

>w
You can't go that way.

>l
White Sand Beach (on the piece of wood)
You are on a beautiful island beach. To the east there is nothing but ocean for as far as the eye can see. This white sand beach extends north and south.  To the west is a lush jungle of green vegetation.

* * *

>n
You can't sail on land. You should probably get off the board.

>get of wood
You would have to get off the piece of wood first.

>n
You can't sail on land. You should probably get off the board.

>get off wood
You dismount the piece of wood.

White Sand Beach
You are on a beautiful island beach. To the east there is nothing but ocean for as far as the eye can see. This white sand beach extends north and south.  To the west is a lush jungle of green vegetation.

You can see a piece of wood here.

>n
North Beach
You are on the beach a little north from where you came ashore.  You can see your sailboard to the south. The palm trees whisper in the wind to the west in the lush jungle.

You can see a Sea Turtle here.

* * *

>w
Rippling Waves
....  You see a piece of wood about six feet in length. You swim over and cling to it gratefully. You look at the wood, and a surge of hope goes through you. This is actually a wide board that has been roughly hewn from a log.

You can see a piece of wood here.

You deeply regret trying to stop your phone from falling over the railing of the ship. Now look what's happened.

What next?  You can say, help, to get more information on how to play.

>get on sood
You can't see any such thing.

>get on wood
Thank goodness!  You were getting exhausted just trying to stay alfloat.

You mount the piece of wood.

* * *

>n
Floating Object (on the piece of wood)
 A body seems to have been the source of a partial meal.

On the body is a jacket.

>l
Floating Object (on the piece of wood)
 A body seems to have been the source of a partial meal.

On the body is a jacket.

>e
Even More Open Water (on the piece of wood)
 There is a stick of very wet driftwood here, about six feet long and and one inch thick.

* * *

>put stick in hole
You place the driftwood stick into the knothole. It's a tight fit, but you manage it. Your little plank surfboard now has a mast.

>put jacket on stick
You can't see any such thing.

>w
Floating Object (on the piece of wood)
 A body seems to have been the source of a partial meal.

On the body is a jacket.

>get jacket
The body is badly decayed. You can't tell if it was male or female.  Your stomach churns from the smell, but you grit your teeth and strip the jacket off.

>l
Floating Object (on the piece of wood)
 A body seems to have been the source of a partial meal.

>put jacket on stick
You drape the jacket over the stick by the collar.
The wind catches the jacket and pulls you along over the waves.

Rushing Waves (on the piece of wood)
You rush along the tops of the waves as a westward wind blows your makeshift sail.  The sail is in the center position and the wind fills it nicely. The board is slippery and wet and hits the occasional wave just so, sending a spray into your face, almost knocking you from the board. You cling to the fragile looking stick of driftwood desperately hoping that it will hold and keep you on the board.

* * *

>l
Rushing Waves (on the piece of wood)
You rush along the tops of the waves as a westward wind blows your makeshift sail.  The sail is in the center position and the wind fills it nicely. The board is slippery and wet and hits the occasional wave just so, sending a spray into your face, almost knocking you from the board. You cling to the fragile looking stick of driftwood desperately hoping that it will hold and keep you on the board.

>l
Journeying On The Waves (on the piece of wood)
A brisk wind wind is blowing. The sun hangs low in the sky. In the distance you can barely make out the shape of an island jutting above the waves

You can see a sail here.

The wind suddenly shifts to the westward! You speed ahead toward the island as the wind catches your fancy jacket-sail.There is the faint outline of an island in the distance.

>l
Journeying On The Waves (on the piece of wood)
A brisk westward wind is blowing. The sun hangs low in the sky. You speed ahead toward the island as the wind catches your fancy jacket-sail.

You can see a centered positioned sail here.

The wind suddenly shifts to the westward! You speed ahead toward the island as the wind catches your fancy jacket-sail.There is the faint outline of an island in the distance.

>l
Island Beach (on the piece of wood)
You are on a beautiful island beach. To the east there is nothing but ocean for as far as the eye can see. The white sand beach extends north and south.  To the west is a lush jungle of green vegetation.

>turn sail right
You can't see any such thing.

>l
Island Beach (on the piece of wood)
You are on a beautiful island beach. To the east there is nothing but ocean for as far as the eye can see. The white sand beach extends north and south.  To the west is a lush jungle of green vegetation.

>turn sail left
You can't see any such thing.

>l
Island Beach (on the piece of wood)
You are on a beautiful island beach. To the east there is nothing but ocean for as far as the eye can see. The white sand beach extends north and south.  To the west is a lush jungle of green vegetation.

>n
You can't sail on land. You should probably get off the board.

>s
You can't sail on land. You should probably get off the board.

>n
You can't sail on land. You should probably get off the board.

* * *

>s
You can't sail on land. You should probably get off the board.

>s
You can't sail on land. You should probably get off the board.

* * *

>n
You can't sail on land. You should probably get off the board.

>n
You can't sail on land. You should probably get off the board.

* * *

>s
You can't sail on land. You should probably get off the board.

>l
Island Beach (on the piece of wood)
You are on a beautiful island beach. To the east there is nothing but ocean for as far as the eye can see. The white sand beach extends north and south.  To the west is a lush jungle of green vegetation.

* * *

>w
You can't go that way.

>s
You can't sail on land. You should probably get off the board.

>get off board
You dismount the piece of wood.

Island Beach
You are on a beautiful island beach. To the east there is nothing but ocean for as far as the eye can see. The white sand beach extends north and south.  To the west is a lush jungle of green vegetation.

You can see a piece of wood here.

>n
North Beach

>s
Island Beach
You are on a beautiful island beach. To the east there is nothing but ocean for as far as the eye can see. The white sand beach extends north and south.  To the west is a lush jungle of green vegetation.

You can see a piece of wood here.

>s
South Beach

* * *

>w
Rippling Waves
....  You see a piece of wood about six feet in length. You swim over and cling to it gratefully. You look at the wood, and a surge of hope goes through you. This is actually a wide board that has been roughly hewn from a log.

You can see a piece of wood here.

You deeply regret trying to stop your phone from falling over the railing of the ship. Now look what's happened.

What next?  You can say, help, to get more information on how to play.

>get on the wood
Thank goodness!  You were getting exhausted just trying to stay alfloat.

You mount the piece of wood.

>e
Ocean Waves (on the piece of wood)
 The water laps at the plank you sit on, rocking you up and down.  A dark object bobs up and down on the surface to the North.

>get off the wood
A dark ominous shape swims up from below and you suddenly decide that it would be better not to get back into the water.

>l
Ocean Waves (on the piece of wood)
 The water laps at the plank you sit on, rocking you up and down.  A dark object bobs up and down on the surface to the North.

>n
Floating Object (on the piece of wood)
 A body seems to have been the source of a partial meal.

On the body is a jacket.

* * *

>get on the wood
Thank goodness!  You were getting exhausted just trying to stay alfloat.

You mount the piece of wood.

>l
Rippling Waves (on the piece of wood)

* * *

>get on the wood
Thank goodness!  You were getting exhausted just trying to stay alfloat.

You mount the piece of wood.

>ne
Floating Object (on the piece of wood)
 A body seems to have been the source of a partial meal.

On the body is a jacket.

* * *

>get stick
Taken.

>put the stick in the hole;
You can't see any such thing.

>put the stick in the hole.
You place the driftwood stick into the knothole. It's a tight fit, but you manage it. Your little plank surfboard now has a mast.

>put the jacket on the stick
You drape the jacket over the stick by the collar.
The wind catches the jacket and pulls you along over the waves.

Rushing Waves (on the piece of wood)
You rush along the tops of the waves as a westward wind blows your makeshift sail.  The sail is in the center position and the wind fills it nicely. The board is slippery and wet and hits the occasional wave just so, sending a spray into your face, almost knocking you from the board. You cling to the fragile looking stick of driftwood desperately hoping that it will hold and keep you on the board.

>l
Rushing Waves (on the piece of wood)
You rush along the tops of the waves as a westward wind blows your makeshift sail.  The sail is in the center position and the wind fills it nicely. The board is slippery and wet and hits the occasional wave just so, sending a spray into your face, almost knocking you from the board. You cling to the fragile looking stick of driftwood desperately hoping that it will hold and keep you on the board.

* * *

>l
Journeying On The Waves (on the piece of wood)
A brisk wind wind is blowing. The sun hangs low in the sky. In the distance you can barely make out the shape of an island jutting above the waves

You can see a sail here.

The wind suddenly shifts to the westward! You speed ahead toward the island as the wind catches your fancy jacket-sail.There is the faint outline of an island in the distance.

>l
Journeying On The Waves (on the piece of wood)
A brisk westward wind is blowing. The sun hangs low in the sky. You speed ahead toward the island as the wind catches your fancy jacket-sail.

You can see a centered positioned sail here.

There is the faint outline of an island in the distance.

>l
Journeying On The Waves (on the piece of wood)
A brisk northwestward wind is blowing. The sun hangs low in the sky. Your speed toward the island has slowed to a crawl.

You can see a centered positioned sail here.

The wind suddenly shifts to the northwestward! Your speed toward the island has slowed to a crawl.There is the faint outline of an island in the distance.

>turn sail right
You twist the mast slightly to the right.
centered positioned sail
There is the faint outline of an island in the distance.

>l
Journeying On The Waves (on the piece of wood)
A brisk southwestward wind is blowing. The sun hangs low in the sky. Your speed toward the island has slowed to a crawl.

You can see a right positioned sail here.

There is the faint outline of an island in the distance.

>turn sail left
You twist the mast slightly to the left.
right positioned sail
There is the faint outline of an island in the distance.

>turn sail left
You twist the mast slightly to the left.
centered positioned sail
The wind suddenly shifts to the southwestward! You speed ahead toward the island as the wind catches your fancy jacket-sail.There is the faint outline of an island in the distance.

>l
Journeying On The Waves (on the piece of wood)
A brisk southwestward wind is blowing. The sun hangs low in the sky. You speed ahead toward the island as the wind catches your fancy jacket-sail.

You can see a left positioned sail here.

The wind suddenly shifts to the westward! Your speed toward the island has slowed to a crawl.There is the faint outline of an island in the distance.

>l
Journeying On The Waves (on the piece of wood)
A brisk westward wind is blowing. The sun hangs low in the sky. Your speed toward the island has slowed to a crawl.

You can see a left positioned sail here.

>l
Journeying On The Waves (on the piece of wood)
A brisk southwestward wind is blowing. The sun hangs low in the sky. You speed ahead toward the island as the wind catches your fancy jacket-sail.

You can see a left positioned sail here.

The island is getting closer.

>l
Journeying On The Waves (on the piece of wood)
A brisk southwestward wind is blowing. The sun hangs low in the sky. You speed ahead toward the island as the wind catches your fancy jacket-sail.

You can see a left positioned sail here.

The wind suddenly shifts to the southwestward! You speed ahead toward the island as the wind catches your fancy jacket-sail.The island is getting closer.

>l
Journeying On The Waves (on the piece of wood)
A brisk southwestward wind is blowing. The sun hangs low in the sky. You speed ahead toward the island as the wind catches your fancy jacket-sail.

You can see a left positioned sail here.

The wind suddenly shifts to the northwestward! Your speed toward the island has slowed to a crawl.The island is getting closer.

A grey fin emerges from the waves.  You frantically try to swerve away from it with your make-shift sail boat, but the shark is too quick.  Eons of evolution has turned it into the perfect predator.  It smells your fear, and in the blink of an eye it's over.

    *** You've been eaten. ***

Would you like to RESTART, RESTORE a saved game, QUIT or UNDO the last command?

* * *

>w
Rippling Waves
....  You see a piece of wood about six feet in length. You swim over and cling to it gratefully. You look at the wood, and a surge of hope goes through you. This is actually a wide board that has been roughly hewn from a log.

You can see a piece of wood here.

You deeply regret trying to stop your phone from falling over the railing of the ship. Now look what's happened.

What next?  You can say, help, to get more information on how to play.

>get on wood
Thank goodness!  You were getting exhausted just trying to stay a float.

You mount the piece of wood.

What next? :

>e
Ocean Waves (on the piece of wood)
....  The water laps at the plank you sit on, rocking you up and down. You can see a dark object bobbing on the surface to the North.

You can see bug here.

What next? :

>n
Glittering Waves (on the piece of wood)
....  What is left of a human body floats on the surface here.  Something has been eating it.

On the body is a jacket.

What next? :

>e
Even More Open Water (on the piece of wood)
 There is a stick of very wet driftwood here, about six feet long and and one inch thick.

* * *

>get all
stick: Taken.

>w
Floating Object (on the piece of wood)
 What is left of a human body floats on the surface here.  Something has been eating on it.

On the body is a jacket.

>get jacket
The body is badly decayed. You can't tell if it was male or female.  Your stomach churns from the smell, but you grit your teeth and strip the jacket off.

>put the stick in the hole
You place the driftwood stick into the knothole. It's a tight fit, but you manage it. Your little plank surfboard now has a mast.

>put the jacket on the stick
You drape the jacket over the stick by the collar.
The wind catches the jacket and pulls you along over the waves.

Rushing Waves (on the piece of wood)
You rush along the tops of the waves as a westward wind blows your makeshift sail.  The sail is in the center position and the wind fills it nicely. The board is slippery and wet and hits the occasional wave just so, sending a spray into your face, almost knocking you from the board. You cling to the fragile looking stick of driftwood desperately hoping that it will hold and keep you on the board.

* * *

>l
Journeying On The Waves (on the piece of wood)
A brisk wind wind is blowing. The sun hangs low in the sky. In the distance you can barely make out the shape of an island jutting above the waves

You can see a sail here.

The wind suddenly shifts to the westward! You speed ahead toward the island as the wind catches your fancy jacket-sail.There is the faint outline of an island in the distance.

>w
You begin to paddle, but it has little effect. Better stick to sailing.

The wind suddenly shifts to the southwestward! Your speed toward the island has slowed to a crawl.There is the faint outline of an island in the distance.

* * *

>n
Glittering Waves (on the piece of wood)
....  What is left of a human body floats on the surface here.  Something has been eating it.

On the body is a jacket.

What next? :

>get all
jacket: The body is badly decayed. You can't tell if it was male or female.  Your stomach churns from the smell, but you grit your teeth and strip the jacket off.

Taken.
knife: Taken.

What next?  You can say, help, to get more information on how to play.

>e
Even More Open Water (on the piece of wood)
....  There is a stick of very wet driftwood here, about six feet long and and one inch thick.

What next?  You can say, help, to get more information on how to play.

>get all
There are none at all available!

>put stick in hole
You can't see any such thing.

>put jacket on stick
You can't see any such thing.

>l
Rippling Waves (on the piece of wood)
 You are sitting on a rough board about six feet in length. All around you is ocean and sky.

>l
Rippling Waves (on the piece of wood)
 You are sitting on a rough board about six feet in length. All around you is ocean and sky.

>turn sail right
You can't see any such thing.

>l
Rippling Waves (on the piece of wood)
 You are sitting on a rough board about six feet in length. All around you is ocean and sky.

>turn sail left
You can't see any such thing.

>l
Rippling Waves (on the piece of wood)
 You are sitting on a rough board about six feet in length. All around you is ocean and sky.

>n
You begin to paddle in that direction but without a plan or destination you soon lose hope and return.

* * *

>e
Even More Open Water (on the piece of wood)
....  There is a stick of very wet driftwood here, about six feet long and and one inch thick.

What next?  You can say, help, to get more information on how to play.

>get stick
You're carrying too many things already.

What next?  You can say, help, to get more information on how to play.

>put knife in pock
You can't see any such thing.

What next?  You can say, help, to get more information on how to play.

>put knife in pocket
You put the knife into pocket.

What next?  You can say, help, to get more information on how to play.

>get stick
Taken.

What next?  You can say, help, to get more information on how to play.

>l
Even More Open Water (on the piece of wood)

What next?  You can say, help, to get more information on how to play.

* * *

>n
Glittering Waves (on the piece of wood)
....  What is left of a human body floats on the surface here.  Something has been eating it.

On the body is a jacket.

What next? :

>get jacket
The body is badly decayed. You can't tell if it was male or female.  Your stomach churns from the smell, but you grit your teeth and strip the jacket off.

Taken.

What next? :

>e
Even More Open Water (on the piece of wood)
....  There is a stick of very wet driftwood here, about six feet long and and three inches thick.

You can see a stick here.

What next? :

>get jacket
You already have that.

* * *

>get stick
Taken.

>put jacket in hole
You put the jacket into the knothole.

>put the stick in the hole
There is no more room in the knothole.

>put the stick on the jacket
Putting things on the jacket would achieve nothing.

>put the jacket on the stick
(first taking the jacket)
You drape the jacket over the stick by the collar.

* * *

>put stick in hole
You place the driftwood stick into the knothole. It's a tight fit, but you manage it. Your little plank surfboard now has a mast.

>put jacket on stick
You drape the jacket over the stick by the collar.
The wind catches the jacket and pulls you along over the waves.

Journeying On The Waves (on the piece of wood)
.... A brisk westward wind is blowing and the sun hangs low in the sky. In the distance you can barely make out the shape of an island jutting above the waves

You can see a centered positioned sail here.

Wind is 2 and sail is 2 and the island is 0.
There is the faint outline of an island in the distance.

>l
Journeying On The Waves (on the piece of wood)
.... A brisk westward wind is blowing and the sun hangs low in the sky. You speed ahead toward the island as the wind catches your centered positioned sail.

Wind is 2 and sail is 2 and the island is 0.
There is the faint outline of an island in the distance.

>l
Journeying On The Waves (on the piece of wood)
.... A brisk westward wind is blowing and the sun hangs low in the sky. You speed ahead toward the island as the wind catches your centered positioned sail.

Wind is 2 and sail is 2 and the island is 0.
The wind suddenly shifts to a northwestward wind!
There is the faint outline of an island in the distance.

>turn sail right
You twist the mast slightly to the right.

Wind is 1 and sail is 3 and the island is -2.
There is the faint outline of an island in the distance.

>l
Journeying On The Waves (on the piece of wood)
.... A brisk northwestward wind is blowing and the sun hangs low in the sky. Your speed toward the island has slowed to a crawl.

You can see a right positioned sail here.

Wind is 1 and sail is 3 and the island is -2.
There is the faint outline of an island in the distance.

>turn sail left
You twist the mast slightly to the left.

Wind is 1 and sail is 2 and the island is -1.
The wind suddenly shifts to a southwestward wind!
There is the faint outline of an island in the distance.

>l
Journeying On The Waves (on the piece of wood)
.... A brisk southwestward wind is blowing and the sun hangs low in the sky. Your speed toward the island has slowed to a crawl.

You can see a centered positioned sail here.

Wind is 3 and sail is 2 and the island is 1.
There is the faint outline of an island in the distance.

>turn sail right
You twist the mast slightly to the right.

Wind is 3 and sail is 3 and the island is 0.

>look
Journeying On The Waves (on the piece of wood)
.... A brisk southwestward wind is blowing and the sun hangs low in the sky. You speed ahead toward the island as the wind catches your right positioned sail.

Wind is 3 and sail is 3 and the island is 0.
The island is getting closer.

>look
Journeying On The Waves (on the piece of wood)
.... A brisk southwestward wind is blowing and the sun hangs low in the sky. You speed ahead toward the island as the wind catches your right positioned sail.

Wind is 3 and sail is 3 and the island is 0.
A southwestward wind continues to blow.
The island is getting closer.

>look
Journeying On The Waves (on the piece of wood)
.... A brisk southwestward wind is blowing and the sun hangs low in the sky. You speed ahead toward the island as the wind catches your right positioned sail.

Wind is 3 and sail is 3 and the island is 0.

>look
Journeying On The Waves (on the piece of wood)
.... A brisk southwestward wind is blowing and the sun hangs low in the sky. You speed ahead toward the island as the wind catches your right positioned sail.

Wind is 3 and sail is 3 and the island is 0.
You've almost made it to the island.

>look
Journeying On The Waves (on the piece of wood)
.... A brisk southwestward wind is blowing and the sun hangs low in the sky. You speed ahead toward the island as the wind catches your right positioned sail.

Wind is 3 and sail is 3 and the island is 0.
The wind suddenly shifts to a northwestward wind!
You've almost made it to the island.

>look
Journeying On The Waves (on the piece of wood)
.... A brisk northwestward wind is blowing and the sun hangs low in the sky. Your speed toward the island has slowed to a crawl.

You can see a right positioned sail here.

Wind is 1 and sail is 3 and the island is -2.
You've almost made it to the island.

>turn sail left
You twist the mast slightly to the left.

Wind is 1 and sail is 2 and the island is -1.
The wind suddenly shifts to a westward wind!
You've almost made it to the island.

>look
Journeying On The Waves (on the piece of wood)
.... A brisk westward wind is blowing and the sun hangs low in the sky. You speed ahead toward the island as the wind catches your centered positioned sail.

Wind is 2 and sail is 2 and the island is 0.
You've almost made it to the island.

>l
Journeying On The Waves (on the piece of wood)
.... A brisk westward wind is blowing and the sun hangs low in the sky. You speed ahead toward the island as the wind catches your centered positioned sail.

Wind is 2 and sail is 2 and the island is 0.

>l
White Sand Beach (on the piece of wood)
.... You are on a beautiful island beach. To the east there is nothing but ocean for as far as the eye can see. This white sand beach extends north and south.  To the west is a lush jungle of green vegetation.

>restart
Are you sure you want to restart?

>yes
.... You are floating in the middle of a tropical ocean.  You hoped that the cruise ship would notice you were missing, but it's been hours and hours, and no ship has appeared on the horizon. You deeply regret trying to stop your phone from falling over the railing of the ship.  Now look what's happened....

Alien Shores....
An Interactive Fiction by Keith B Phillips
Release 1 / Serial number 180910 / Inform 7 build 6M62 (I6/v6.33 lib 6/12N) SD

Ocean Waves
....  You lay on your back in the warm water as your body floats up and down the rythmic waves. The hot sun beats down on you and there is not a cloud in the clear blue sky.

>look
Ocean Waves
....  You lay on your back in the warm water as your body floats up and down the rythmic waves. The hot sun beats down on you and there is not a cloud in the clear blue sky. 

You must have hit your head against the ship during the fall.  A small raised lump on the back of your skull is throbbing.

>w
Rippling Waves
....  You see a piece of wood about six feet in length. You swim over and cling to it gratefully. You look at the wood, and a surge of hope goes through you. This is actually a wide board that has been roughly hewn from a log.

You can see a piece of wood here.

This really sucks. You could be kicking back right now having an ice-cold drink in the ship's lounge.

* * *

>e
Even More Open Water (on the piece of wood)
....  There is a stick of very wet driftwood here, about six feet long and and three inches thick.

You can see a stick here.

What next? :

>get sitck
You can't see any such thing.

>get stick
Taken.

>get off the wood
A dark ominous shape swims up from below and you suddenly decide that it would be better not to get back into the water.

>put stick in hole
You place the driftwood stick into the knothole. It's a tight fit, but you manage it. Your little plank surfboard now has a mast.

* * *

>l
Journeying On The Waves (on the piece of wood)
A brisk westward wind is blowing. The sun hangs low in the sky. You speed ahead toward the island as the wind catches your fancy jacket-sail.

You can see a centered positioned sail here.

There is the faint outline of an island in the distance.

>l
Journeying On The Waves (on the piece of wood)
A brisk westward wind is blowing. The sun hangs low in the sky. You speed ahead toward the island as the wind catches your fancy jacket-sail.

You can see a centered positioned sail here.

>l
Journeying On The Waves (on the piece of wood)
A brisk westward wind is blowing. The sun hangs low in the sky. You speed ahead toward the island as the wind catches your fancy jacket-sail.

You can see a centered positioned sail here.

The island is getting closer.

>l
Journeying On The Waves (on the piece of wood)
A brisk westward wind is blowing. The sun hangs low in the sky. You speed ahead toward the island as the wind catches your fancy jacket-sail.

You can see a centered positioned sail here.

The island is getting closer.

>l
Journeying On The Waves (on the piece of wood)
A brisk westward wind is blowing. The sun hangs low in the sky. You speed ahead toward the island as the wind catches your fancy jacket-sail.

You can see a centered positioned sail here.

>l
Journeying On The Waves (on the piece of wood)
A brisk westward wind is blowing. The sun hangs low in the sky. You speed ahead toward the island as the wind catches your fancy jacket-sail.

You can see a centered positioned sail here.

You've almost made it to the island.

>l
Journeying On The Waves (on the piece of wood)
A brisk westward wind is blowing. The sun hangs low in the sky. You speed ahead toward the island as the wind catches your fancy jacket-sail.

You can see a centered positioned sail here.

You've almost made it to the island.

>l
Journeying On The Waves (on the piece of wood)
A brisk westward wind is blowing. The sun hangs low in the sky. You speed ahead toward the island as the wind catches your fancy jacket-sail.

You can see a centered positioned sail here.

The wind suddenly shifts to the westward! You speed ahead toward the island as the wind catches your fancy jacket-sail.You've almost made it to the island.

>l
Journeying On The Waves (on the piece of wood)
A brisk westward wind is blowing. The sun hangs low in the sky. You speed ahead toward the island as the wind catches your fancy jacket-sail.

You can see a centered positioned sail here.

>l
Island Beach (on the piece of wood)
You are on a beautiful island beach. To the east there is nothing but ocean for as far as the eye can see. The white sand beach extends north and south.  To the west is a lush jungle of green vegetation.

>n
North Beach (on the piece of wood)

>s
Island Beach (on the piece of wood)
You are on a beautiful island beach. To the east there is nothing but ocean for as far as the eye can see. The white sand beach extends north and south.  To the west is a lush jungle of green vegetation.

>get off the wood
You dismount the piece of wood.

Island Beach
You are on a beautiful island beach. To the east there is nothing but ocean for as far as the eye can see. The white sand beach extends north and south.  To the west is a lush jungle of green vegetation.

You can see a piece of wood here.

>n
North Beach

* * *

>s
South Beach

>n
Island Beach
You are on a beautiful island beach. To the east there is nothing but ocean for as far as the eye can see. The white sand beach extends north and south.  To the west is a lush jungle of green vegetation.

You can see a piece of wood here.

>w
You can't go that way.

* * *

>e
Even More Open Water (on the piece of wood)
....  There is a stick of very wet driftwood here, about six feet long and and three inches thick.

You can see a stick here.

What next? :

>get stick
Taken.

What next? :

>l
Even More Open Water (on the piece of wood)
....  There is a stick of very wet driftwood here, about six feet long and and three inches thick.

What next? :

>put stick in hole
You place the driftwood stick into the knothole. It's a tight fit, but you manage it. Your little plank surfboard now has a mast.

What next? :

>put the jacket on the stick
You drape the jacket over the stick by the collar.
The wind catches the jacket and pulls you along over the waves.

Journeying On The Waves (on the piece of wood)
.... A brisk east wind is blowing and the sun hangs low in the sky. In the distance you can barely make out the shape of an island jutting above the waves

You can see a centered positioned sail here.

There is the faint outline of an island in the distance.

What next? :

>l
Journeying On The Waves (on the piece of wood)
.... A brisk east wind is blowing and the sun hangs low in the sky. You speed ahead toward the island as the wind catches your centered positioned sail.

There is the faint outline of an island in the distance.

What next? :

>l
Journeying On The Waves (on the piece of wood)
.... A brisk east wind is blowing and the sun hangs low in the sky. You speed ahead toward the island as the wind catches your centered positioned sail.

What next? :

>l
Journeying On The Waves (on the piece of wood)
.... A brisk east wind is blowing and the sun hangs low in the sky. You speed ahead toward the island as the wind catches your centered positioned sail.

The wind suddenly shifts to northeast wind!

What next? :

>l
Journeying On The Waves (on the piece of wood)
.... A brisk northeast wind is blowing and the sun hangs low in the sky. Your speed toward the island has slowed to a crawl.

You can see a centered positioned sail here.

What next? :

>turn sail left
You twist the mast slightly to the left.

The wind suddenly shifts to southeast wind!

What next? :

>l
Journeying On The Waves (on the piece of wood)
.... A brisk southeast wind is blowing and the sun hangs low in the sky. Your speed toward the island has slowed to a crawl.

You can see a left positioned sail here.

The wind suddenly shifts to northeast wind!
The island is getting closer.

What next? :

>turn sail right
You twist the mast slightly to the right.

The wind suddenly shifts to southeast wind!
The island is getting closer.

What next? :

>turn sail right
You twist the mast slightly to the right.

The island is getting closer.

What next? :

>l
Journeying On The Waves (on the piece of wood)
.... A brisk southeast wind is blowing and the sun hangs low in the sky. You speed ahead toward the island as the wind catches your right positioned sail.

What next? :

>l
Journeying On The Waves (on the piece of wood)
.... A brisk southeast wind is blowing and the sun hangs low in the sky. You speed ahead toward the island as the wind catches your right positioned sail.

You've almost made it to the island.

What next? :

>l
Journeying On The Waves (on the piece of wood)
.... A brisk southeast wind is blowing and the sun hangs low in the sky. You speed ahead toward the island as the wind catches your right positioned sail.

You've almost made it to the island.

What next? :

>l
Journeying On The Waves (on the piece of wood)
.... A brisk southeast wind is blowing and the sun hangs low in the sky. You speed ahead toward the island as the wind catches your right positioned sail.

What next? :

>l
White Sand Beach (on the piece of wood)
.... You are on a beautiful island beach. To the east there is nothing but ocean for as far as the eye can see. This white sand beach extends north and south.  To the west is a lush jungle of green vegetation.

You can see a palm tree here.

What next? :

>n
You can't sail on land. You should probably get off the board.

What next? :

* * *

>get stick
Taken.

What next? :

>put stick in hole
You place the driftwood stick into the knothole. It's a tight fit, but you manage it. Your little plank surfboard now has a mast.

What next? :

>put jacket on stick
You drape the jacket over the stick by the collar.
The wind catches the jacket and pulls you along over the waves.

Journeying On The Waves (on the piece of wood)
.... A brisk east wind is blowing and the sun hangs low in the sky. In the distance you can barely make out the shape of an island jutting above the waves

You can see a centered positioned sail here.

The wind suddenly shifts to northeast wind!
There is the faint outline of an island in the distance.

What next? :

>l
Journeying On The Waves (on the piece of wood)
.... A brisk northeast wind is blowing and the sun hangs low in the sky. Your speed toward the island has slowed to a crawl.

You can see a centered positioned sail here.

There is the faint outline of an island in the distance.

What next? :

>l
Journeying On The Waves (on the piece of wood)
.... A brisk westward wind is blowing and the sun hangs low in the sky. You speed ahead toward the island as the wind catches your centered positioned sail.

Wind is 2 and sail is 2 and the island is 0.

What next?

>l
Journeying On The Waves (on the piece of wood)
.... A brisk westward wind is blowing and the sun hangs low in the sky. You speed ahead toward the island as the wind catches your centered positioned sail.

Wind is 2 and sail is 2 and the island is 0.
The island is getting closer.

What next?

>l
Journeying On The Waves (on the piece of wood)
.... A brisk westward wind is blowing and the sun hangs low in the sky. You speed ahead toward the island as the wind catches your centered positioned sail.

Wind is 2 and sail is 2 and the island is 0.
The island is getting closer.

What next?

* * *

>l
Journeying On The Waves (on the piece of wood)
.... A brisk westward wind is blowing and the sun hangs low in the sky. You speed ahead toward the island as the wind catches your centered positioned sail.

Wind is 2 and sail is 2 and the island is 0.

What next?

>turn sail left
You twist the mast slightly to the left.

Wind is 2 and sail is 1 and the island is 1.

What next?

>l
Journeying On The Waves (on the piece of wood)
.... A brisk westward wind is blowing and the sun hangs low in the sky. Your speed toward the island has slowed to a crawl.

You can see a left positioned sail here.

Wind is 2 and sail is 1 and the island is 1.
The wind suddenly shifts to a northwestward wind!
You've almost made it to the island.

What next?

>turn sail right
You twist the mast slightly to the right.

Wind is 1 and sail is 2 and the island is -1.
You've almost made it to the island.

What next?

>l
Journeying On The Waves (on the piece of wood)
.... A brisk northwestward wind is blowing and the sun hangs low in the sky. Your speed toward the island has slowed to a crawl.

You can see a centered positioned sail here.

Wind is 1 and sail is 2 and the island is -1.
You've almost made it to the island.

What next?

>l
Journeying On The Waves (on the piece of wood)
.... A brisk northwestward wind is blowing and the sun hangs low in the sky. Your speed toward the island has slowed to a crawl.

You can see a centered positioned sail here.

Wind is 1 and sail is 2 and the island is -1.
A northwestward wind continues to blow.
You've almost made it to the island.

What next?

>turn sail right
You twist the mast slightly to the right.

Wind is 1 and sail is 3 and the island is -2.
You've almost made it to the island.

What next?

>l
Journeying On The Waves (on the piece of wood)
.... A brisk northwestward wind is blowing and the sun hangs low in the sky. Your speed toward the island has slowed to a crawl.

You can see a right positioned sail here.

Wind is 1 and sail is 3 and the island is -2.
You've almost made it to the island.

What next?

>turn sail right
You twist the mast slightly to the right.

Wind is 1 and sail is 4 and the island is -3.
You've almost made it to the island.

What next?

>turn sail right
You twist the mast slightly to the right.

Wind is 1 and sail is 5 and the island is -4.
The wind suddenly shifts to a southwestward wind!
You've almost made it to the island.

What next?

>l
Journeying On The Waves (on the piece of wood)
.... A brisk southwestward wind is blowing and the sun hangs low in the sky. Your speed toward the island has slowed to a crawl.

You can see a right positioned sail here.

Wind is 3 and sail is 5 and the island is -2.
You've almost made it to the island.

What next?

>lturn sail left
That's not a verb I recognise.

What next?

>turn sail left
You twist the mast slightly to the left.

Wind is 3 and sail is 4 and the island is -1.
The wind suddenly shifts to a northwestward wind!
You've almost made it to the island.

What next?

>turn sail left
You twist the mast slightly to the left.

Wind is 1 and sail is 3 and the island is -2.
The wind suddenly shifts to a westward wind!
You've almost made it to the island.

What next?

>l
Journeying On The Waves (on the piece of wood)
.... A brisk westward wind is blowing and the sun hangs low in the sky. Your speed toward the island has slowed to a crawl.

You can see a right positioned sail here.

Wind is 2 and sail is 3 and the island is -1.
You've almost made it to the island.

A grey fin emerges from the waves. Adrenaline kicks in, but you manage to hold yourself together.  You guide your make-shift sailboard away from the creature until the fin submerges. For a moment you feel somewhat relieved, and then you wonder where the creature has gone to.

What next?

>l
Journeying On The Waves (on the piece of wood)
.... A brisk westward wind is blowing and the sun hangs low in the sky. Your speed toward the island has slowed to a crawl.

You can see a right positioned sail here.

Wind is 2 and sail is 3 and the island is -1.
You've almost made it to the island.

A grey fin emerges from the waves. Adrenaline kicks in, but you manage to hold yourself together.  You guide your make-shift sailboard away from the creature until the fin submerges. For a moment you feel somewhat relieved, and then you wonder where the creature has gone to.

What next?

>get off board
A dark ominous shape swims up from below and you suddenly decide that it would be better not to get back into the water.

Wind is 2 and sail is 3 and the island is -1.
You've almost made it to the island.

A grey fin emerges from the waves. Adrenaline kicks in, but you manage to hold yourself together.  You guide your make-shift sailboard away from the creature until the fin submerges. For a moment you feel somewhat relieved, and then you wonder where the creature has gone to.
Suddenly the shark reappears next to your board.  This time it is too quick.  Eons of evolution has turned it into the perfect predator. You look over and see a big toothy grin. You imagine he's your pal, just surfing along with you on the waves, having a good time. It's easier that way.  The end comes in the blink of eye.

    *** You have been eaten. ***

Would you like to RESTART, RESTORE a saved game, QUIT or UNDO the last command?

>s
Please give one of the answers above.

Would you like to RESTART, RESTORE a saved game, QUIT or UNDO the last command?

>w
Please give one of the answers above.

Would you like to RESTART, RESTORE a saved game, QUIT or UNDO the last command?

>look at Ono
Please give one of the answers above.

Would you like to RESTART, RESTORE a saved game, QUIT or UNDO the last command?

>look at Akule
Please give one of the answers above.

Would you like to RESTART, RESTORE a saved game, QUIT or UNDO the last command?

>l
Please give one of the answers above.

Would you like to RESTART, RESTORE a saved game, QUIT or UNDO the last command?

>look at Monchong
Please give one of the answers above.

Would you like to RESTART, RESTORE a saved game, QUIT or UNDO the last command?

>look at Akule
Please give one of the answers above.

Would you like to RESTART, RESTORE a saved game, QUIT or UNDO the last command?

>restart
.... You are floating in the middle of a tropical ocean.  You hoped that the cruise ship would notice you were missing, but it's been hours, and no ship has appeared on the horizon. You deeply regret trying to stop your phone from falling over the railing of the ship. Now look what's happened.

Alien Shores....
An Interactive Fiction by Keith B Phillips.... Say look, or north, east, west south to move.
Release 1 / Serial number 180910 / Inform 7 build 6M62 (I6/v6.33 lib 6/12N) SD

Ocean Waves
....  You lay on your back in the warm water as your body floats up and down the rythmic waves. The hot sun beats down on you and there is not a cloud in the clear blue sky.  Say look, or north, east, west south to move.

* * *

>l
Journeying On The Waves (on the piece of wood)
.... A brisk westward wind is blowing and the sun hangs low in the sky. You speed ahead toward the island as the wind catches your centered positioned sail.

Wind is 2 and sail is 2 and the island is 0.

What next?

>turn sail right
You twist the mast slightly to the right.

Wind is 2 and sail is 3 and the island is -1.

What next?

>l
Journeying On The Waves (on the piece of wood)
.... A brisk westward wind is blowing and the sun hangs low in the sky. Your speed toward the island has slowed to a crawl.

You can see a right positioned sail here.

Wind is 2 and sail is 3 and the island is -1.
The wind suddenly shifts to a southwestward wind!
You've almost made it to the island.

What next?

>l
Journeying On The Waves (on the piece of wood)
.... A brisk southwestward wind is blowing and the sun hangs low in the sky. You speed ahead toward the island as the wind catches your right positioned sail.

Wind is 3 and sail is 3 and the island is 0.
The wind suddenly shifts to a northwestward wind!
You've almost made it to the island.

What next?

>l
Journeying On The Waves (on the piece of wood)
.... A brisk northwestward wind is blowing and the sun hangs low in the sky. Your speed toward the island has slowed to a crawl.

You can see a right positioned sail here.

Wind is 1 and sail is 3 and the island is -2.
A northwestward wind continues to blow.
You've almost made it to the island.

What next?

>l
Journeying On The Waves (on the piece of wood)
.... A brisk northwestward wind is blowing and the sun hangs low in the sky. Your speed toward the island has slowed to a crawl.

You can see a right positioned sail here.

Wind is 1 and sail is 3 and the island is -2.
You've almost made it to the island.

What next?

>turn sail left
You twist the mast slightly to the left.

Wind is 1 and sail is 2 and the island is -1.
You've almost made it to the island.

What next?

>turn sail left
You twist the mast slightly to the left.

Wind is 1 and sail is 1 and the island is 0.
You've almost made it to the island.

What next?

>l
Journeying On The Waves (on the piece of wood)
.... A brisk northwestward wind is blowing and the sun hangs low in the sky. You speed ahead toward the island as the wind catches your left positioned sail.

Wind is 1 and sail is 1 and the island is 0.
The wind suddenly shifts to a westward wind!
You've almost made it to the island.

What next?

>l
Journeying On The Waves (on the piece of wood)
.... A brisk westward wind is blowing and the sun hangs low in the sky. Your speed toward the island has slowed to a crawl.

You can see a left positioned sail here.

Wind is 2 and sail is 1 and the island is 1.
The wind suddenly shifts to a southwestward wind!
You've almost made it to the island.

What next?

>l
Journeying On The Waves (on the piece of wood)
.... A brisk southwestward wind is blowing and the sun hangs low in the sky. Your speed toward the island has slowed to a crawl.

You can see a left positioned sail here.

Wind is 3 and sail is 1 and the island is 2.
You've almost made it to the island.

What next?

>turn sail right
You twist the mast slightly to the right.

Wind is 3 and sail is 2 and the island is 1.
The wind suddenly shifts to a westward wind!
You've almost made it to the island.

What next?

>l
Journeying On The Waves (on the piece of wood)
.... A brisk westward wind is blowing and the sun hangs low in the sky. You speed ahead toward the island as the wind catches your centered positioned sail.

Wind is 2 and sail is 2 and the island is 0.

What next?

>get off wood
You dismount the piece of wood.

White Sand Beach
.... You are on a beautiful island beach. To the east there is nothing but ocean for as far as the eye can see. This white sand beach extends north and south.  To the west is a lush jungle of green vegetation.

You can see a piece of wood and a palm tree here.

What next?

>l
White Sand Beach
.... You are on a beautiful island beach. To the east there is nothing but ocean for as far as the eye can see. This white sand beach extends north and south.  To the west is a lush jungle of green vegetation.

You can see a piece of wood and a palm tree here.

What next?

>n
North Beach
.... You are on the beach a little north from where you came ashore.  You can see your sailboard to the south. The palm trees whisper in the wind to the west in the lush jungle.

You can see a Sea Turtle here.

What next?

>n
You can't go that way.

The sun continues to sink slowly into the west behind the tree line, and twilight covers the island.  You hear noises in the jungle of things moving about the underbrush. A primal part of your brain kicks in as your heart rate goes up.

What next?

>s
White Sand Beach
.... You are on a beautiful island beach. To the east there is nothing but ocean for as far as the eye can see. This white sand beach extends north and south.  To the west is a lush jungle of green vegetation.

You can see a piece of wood and a palm tree here.

What next?

>n
North Beach
.... You are on the beach a little north from where you came ashore.  You can see your sailboard to the south. The palm trees whisper in the wind to the west in the lush jungle.

You can see a Sea Turtle here.

Darkness covers the island, and the stars stand out brightly in the canvas of the sky.  The things going bump in the night haven't killed you yet and you've had an extemely long day. You find your eyelids slipping closed and your head nods.  You fight to stay awake, worried about the unknown, but you are so tired that you don't care any more.  You fall into a deep, restful and dreamless sleep.
You awake with the sun shining hotly into your eyes from the east.  You get up and stretch.  A deep yawn escapes your lips, and then your stomach growls ominously with out warning. You are incredibly hungry, and a bit thirsty too.

Your stomach aches with hunger. You better find something to eat soon.

What next?

>s
White Sand Beach
.... You are on a beautiful island beach. To the east there is nothing but ocean for as far as the eye can see. This white sand beach extends north and south.  To the west is a lush jungle of green vegetation.

You can see a piece of wood and a palm tree here.

What next?

>l
White Sand Beach
.... You are on a beautiful island beach. To the east there is nothing but ocean for as far as the eye can see. This white sand beach extends north and south.  To the west is a lush jungle of green vegetation.

You can see a piece of wood and a palm tree here.

What next?

>w
You can't go that way.

What next?

>s
South Beach
.... You are on the beach a little south from where you came ashore.  You can see your sailboard to the north. The surf washes over the sand with a sigh and hiss. The jungle is to the west.

What next?

>w
You can't go that way.

What next?

* * *

>l
Journeying On The Waves (on the piece of wood)
.... A brisk northeast wind is blowing and the sun hangs low in the sky. Your speed toward the island has slowed to a crawl.

You can see a centered positioned sail here.

There is the faint outline of an island in the distance.

What next? :

>w
You continue to sail toward the island in the west, and you watch the wind pushing the sail to see if you need to turn it left or right. .... A brisk northeast wind is blowing and the sun hangs low in the sky. Your speed toward the island has slowed to a crawl.
The wind suddenly shifts to east wind!
There is the faint outline of an island in the distance.

What next? :

>e
You continue to sail toward the island in the west, and you watch the wind pushing the sail to see if you need to turn it left or right. .... A brisk east wind is blowing and the sun hangs low in the sky. You speed ahead toward the island as the wind catches your centered positioned sail.
There is the faint outline of an island in the distance.

What next? :

>n
You continue to sail toward the island in the west, and you watch the wind pushing the sail to see if you need to turn it left or right. .... A brisk east wind is blowing and the sun hangs low in the sky. You speed ahead toward the island as the wind catches your centered positioned sail.
What next? :

>s
You continue to sail toward the island in the west, and you watch the wind pushing the sail to see if you need to turn it left or right. .... A brisk east wind is blowing and the sun hangs low in the sky. You speed ahead toward the island as the wind catches your centered positioned sail.
The island is getting closer.

What next? :

>w
You continue to sail toward the island in the west, and you watch the wind pushing the sail to see if you need to turn it left or right. .... A brisk east wind is blowing and the sun hangs low in the sky. You speed ahead toward the island as the wind catches your centered positioned sail.
The island is getting closer.

What next? :

>w
You continue to sail toward the island in the west, and you watch the wind pushing the sail to see if you need to turn it left or right. .... A brisk east wind is blowing and the sun hangs low in the sky. You speed ahead toward the island as the wind catches your centered positioned sail.
What next? :

>w
You continue to sail toward the island in the west, and you watch the wind pushing the sail to see if you need to turn it left or right. .... A brisk east wind is blowing and the sun hangs low in the sky. You speed ahead toward the island as the wind catches your centered positioned sail.
You've almost made it to the island.

What next? :

>w
You continue to sail toward the island in the west, and you watch the wind pushing the sail to see if you need to turn it left or right. .... A brisk east wind is blowing and the sun hangs low in the sky. You speed ahead toward the island as the wind catches your centered positioned sail.
You've almost made it to the island.

What next? :

>turn sail right
You twist the mast slightly to the right. .... A brisk east wind is blowing and the sun hangs low in the sky. You speed ahead toward the island as the wind catches your centered positioned sail.
The wind suddenly shifts to northeast wind!
You've almost made it to the island.

What next? :

>turn sail left
You twist the mast slightly to the left. .... A brisk northeast wind is blowing and the sun hangs low in the sky. Your speed toward the island has slowed to a crawl. 
You've almost made it to the island.

What next? :

>l
Journeying On The Waves (on the piece of wood)
.... A brisk northeast wind is blowing and the sun hangs low in the sky. Your speed toward the island has slowed to a crawl.

You can see a centered positioned sail here.

You've almost made it to the island.

What next? :

>turn sail left
You twist the mast slightly to the left. .... A brisk northeast wind is blowing and the sun hangs low in the sky. Your speed toward the island has slowed to a crawl. 
You've almost made it to the island.

What next? :

>l
Journeying On The Waves (on the piece of wood)
.... A brisk northeast wind is blowing and the sun hangs low in the sky. You speed ahead toward the island as the wind catches your left positioned sail.

The wind suddenly shifts to southeast wind!
You've almost made it to the island.

What next? :

>turn sail right
You twist the mast slightly to the right. .... A brisk southeast wind is blowing and the sun hangs low in the sky. Your speed toward the island has slowed to a crawl.
You've almost made it to the island.

What next? :

>turn sail right
You twist the mast slightly to the right. .... A brisk southeast wind is blowing and the sun hangs low in the sky. Your speed toward the island has slowed to a crawl.
A southeast wind continues to blow.

What next? :

>l
White Sand Beach (on the piece of wood)
.... You are on a beautiful island beach. To the east there is nothing but ocean for as far as the eye can see. This white sand beach extends north and south.  To the west is a lush jungle of green vegetation.

You can see a palm tree here.

What next? :

* * *

>put jacket on stick
You drape the jacket over the stick by the collar.
The wind catches the jacket and pulls you along over the waves.

Journeying On The Waves (on the piece of wood)
.... A brisk east wind is blowing and the sun hangs low in the sky. In the distance you can barely make out the shape of an island jutting above the waves

You can see a centered positioned sail here.

The wind suddenly shifts to northeast wind!
There is the faint outline of an island in the distance.

What next? :

>w
You begin to paddle, but it has little effect. Better stick to sailing. You watch the wind pushing the sail to see if you need to turn it left or right.

Wind is 2 and sail is 2 and the island is 0.
There is the faint outline of an island in the distance.

What next? :

>w
You begin to paddle, but it has little effect. Better stick to sailing. You watch the wind pushing the sail to see if you need to turn it left or right.

Wind is 2 and sail is 2 and the island is 0.
The wind suddenly shifts to a northwestward wind!
There is the faint outline of an island in the distance.

What next?

>w
You begin to paddle, but it has little effect. Better stick to sailing. You watch the wind pushing the sail to see if you need to turn it left or right.

Wind is 1 and sail is 2 and the island is -1.
The wind suddenly shifts to a westward wind!

What next?

>w
You begin to paddle, but it has little effect. Better stick to sailing. You watch the wind pushing the sail to see if you need to turn it left or right.

Wind is 2 and sail is 2 and the island is 0.
The island is getting closer.

What next?

>w
You begin to paddle, but it has little effect. Better stick to sailing. You watch the wind pushing the sail to see if you need to turn it left or right.

Wind is 2 and sail is 2 and the island is 0.
The island is getting closer.

What next?

>l
Journeying On The Waves (on the piece of wood)
.... A brisk westward wind is blowing and the sun hangs low in the sky. You speed ahead toward the island as the wind catches your centered positioned sail.

Wind is 2 and sail is 2 and the island is 0.

What next?

* * *

>l
Journeying On The Waves (on the piece of wood)
.... A brisk westward wind is blowing and the sun hangs low in the sky. You speed ahead toward the island as the wind catches your centered positioned sail.

Wind is 2 and sail is 2 and the island is 0.
You've almost made it to the island.

What next?

>l
Journeying On The Waves (on the piece of wood)
.... A brisk westward wind is blowing and the sun hangs low in the sky. You speed ahead toward the island as the wind catches your centered positioned sail.

Wind is 2 and sail is 2 and the island is 0.
The wind suddenly shifts to a northwestward wind!
You've almost made it to the island.

What next?

>turn sail left
You twist the mast slightly to the left.

Wind is 1 and sail is 1 and the island is 0.
The wind suddenly shifts to a southwestward wind!
You've almost made it to the island.

What next?

>turn sail right
You twist the mast slightly to the right.

Wind is 3 and sail is 2 and the island is 1.
You've almost made it to the island.

What next?

>turn sail right
You twist the mast slightly to the right.

Wind is 3 and sail is 3 and the island is 0.
The wind suddenly shifts to a westward wind!
You've almost made it to the island.

What next?

>l
Journeying On The Waves (on the piece of wood)
.... A brisk westward wind is blowing and the sun hangs low in the sky. Your speed toward the island has slowed to a crawl.

You can see a right positioned sail here.

Wind is 2 and sail is 3 and the island is -1.
The wind suddenly shifts to a northwestward wind!
You've almost made it to the island.

What next?

>turn sail left
You twist the mast slightly to the left.

Wind is 1 and sail is 2 and the island is -1.
You've almost made it to the island.

What next?

* * *

>turn sail left
You twist the mast slightly to the left.

Wind is 1 and sail is 1 and the island is 0.
You've almost made it to the island.

What next?

>l
Journeying On The Waves (on the piece of wood)
.... A brisk northwestward wind is blowing and the sun hangs low in the sky. You speed ahead toward the island as the wind catches your left positioned sail.

Wind is 1 and sail is 1 and the island is 0.
The wind suddenly shifts to a southwestward wind!
You've almost made it to the island.

What next?

>l
Journeying On The Waves (on the piece of wood)
.... A brisk southwestward wind is blowing and the sun hangs low in the sky. Your speed toward the island has slowed to a crawl.

You can see a left positioned sail here.

Wind is 3 and sail is 1 and the island is 2.
The wind suddenly shifts to a northwestward wind!
You've almost made it to the island.

What next?

>turn sail left
You twist the mast slightly to the left.

Wind is 1 and sail is 0 and the island is 1.
A northwestward wind continues to blow.
You've almost made it to the island.

What next?

>l
Journeying On The Waves (on the piece of wood)
.... A brisk northwestward wind is blowing and the sun hangs low in the sky. Your speed toward the island has slowed to a crawl.

You can see a left positioned sail here.

Wind is 1 and sail is 0 and the island is 1.
You've almost made it to the island.

A grey fin emerges from the waves. Adrenaline kicks in, but you manage to hold yourself together.  You guide your make-shift sailboard away from the creature until the fin submerges. For a moment you feel somewhat relieved, and then you wonder where the creature has gone to.

What next?

>turn sail right
You twist the mast slightly to the right.

Wind is 1 and sail is 1 and the island is 0.

What next?

>turn sail right
You can't see any such thing.

What next?

>turn sail right
You can't see any such thing.

What next?

>l
White Sand Beach (on the piece of wood)
.... You are on a beautiful island beach. To the east there is nothing but ocean for as far as the eye can see. This white sand beach extends north and south.  To the west is a lush jungle of green vegetation.

You can see a palm tree here.

What next?

>look at sail
You can't see any such thing.

What next?

>look at board
It's a sturdy wide plank with a round knothole in the middle of it.

What next?

>look at knothole
In the knothole is a stick.

What next?

>look at stick
On the stick is a jacket.

The sun continues to sink slowly into the west behind the tree line, and twilight covers the island.  You hear noises in the jungle of things moving about the underbrush. A primal part of your brain kicks in as your heart rate goes up.

What next?

>get off jacket
But you aren't on the jacket at the moment.

What next?

>l
White Sand Beach (on the piece of wood)
.... You are on a beautiful island beach. To the east there is nothing but ocean for as far as the eye can see. This white sand beach extends north and south.  To the west is a lush jungle of green vegetation.

You can see a palm tree here.

Darkness covers the island, and the stars stand out brightly in the canvas of the sky.  The things going bump in the night haven't killed you yet and you've had an extemely long day. You find your eyelids slipping closed and your head nods.  You fight to stay awake, worried about the unknown, but you are so tired that you don't care any more.  You fall into a deep, restful and dreamless sleep.
You awake with the sun shining hotly into your eyes from the east.  You get up and stretch.  A deep yawn escapes your lips, and then your stomach growls ominously with out warning. You are incredibly hungry, and a bit thirsty too.

Your stomach aches with hunger. You better find something to eat soon.

What next?

>s
You can't sail on land. You should probably get off the board.

What next?

>get off board
You dismount the piece of wood.

White Sand Beach
.... You are on a beautiful island beach. To the east there is nothing but ocean for as far as the eye can see. This white sand beach extends north and south.  To the west is a lush jungle of green vegetation.

You can see a piece of wood and a palm tree here.

What next?

>s
South Beach
.... You are on the beach a little south from where you came ashore.  You can see your sailboard to the north. The surf washes over the sand with a sigh and hiss. The jungle is to the west and there is a little pool of water to the west from which a narrow stream of water flows out into the ocean.

What next?

>w
Tidal Pool
.... There is a small pool of water which appears to be fed by a stream flowing out of the jungle to the west. The water is so crystal clear that you can easily see the bottom.  In the pool several fish of varying sizes and spectacular colors swim leisurely about in the warm water.

What next?

>l
Tidal Pool
.... There is a small pool of water which appears to be fed by a stream flowing out of the jungle to the west. The water is so crystal clear that you can easily see the bottom.  In the pool several fish of varying sizes and spectacular colors swim leisurely about in the warm water.

What next?

* * *

>get stick
Taken.

What next? :

>put stick in knothole
You place the driftwood stick into the knothole. It's a tight fit, but you manage it. Your little plank surfboard now has a mast.

>put jacket on stick
You drape the jacket over the stick by the collar.
The wind catches the jacket and pulls you along over the waves.

Rushing Waves (on the piece of wood)
You rush along the tops of the waves as a westward wind blows your makeshift sail.  The sail is in the center position and the wind fills it nicely. The board is slippery and wet and hits the occasional wave just so, sending a spray into your face, almost knocking you from the board. You cling to the fragile looking stick of driftwood desperately hoping that it will hold and keep you on the board.

* * *

>l
Journeying On The Waves (on the piece of wood)
A brisk wind wind is blowing. The sun hangs low in the sky over a distant island. Island

You can see a sail here.

>w
You begin to paddle in that direction but without a plan or destination you soon lose hope and return.

* * *

>put stick in knothole
You place the driftwood stick into the knothole. It's a tight fit, but you manage it. Your little plank surfboard now has a mast.

>put jacket on the stick
You drape the jacket over the stick by the collar.
The wind catches the jacket and pulls you along over the waves.

Rushing Waves (on the piece of wood)
You rush along the tops of the waves as a westward wind blows your makeshift sail.  The sail is in the center position and the wind fills it nicely. The board is slippery and wet and hits the occasional wave just so, sending a spray into your face, almost knocking you from the board. You cling to the fragile looking stick of driftwood desperately hoping that it will hold and keep you on the board.

>l
Rushing Waves (on the piece of wood)
You rush along the tops of the waves as a westward wind blows your makeshift sail.  The sail is in the center position and the wind fills it nicely. The board is slippery and wet and hits the occasional wave just so, sending a spray into your face, almost knocking you from the board. You cling to the fragile looking stick of driftwood desperately hoping that it will hold and keep you on the board.

* * *

>l
Journeying On The Waves (on the piece of wood)
A brisk wind wind is blowing. The sun hangs low in the sky over a distant island. Island

You can see a sail here.

>l
Journeying On The Waves (on the piece of wood)
A brisk westward wind is blowing. The sun hangs low in the sky over a distant island. You speed ahead toward the island as the wind catches your fancy jacket-sail.

You can see a centered positioned sail here.

The wind suddenly shifts to the westward! You speed ahead toward the island as the wind catches your fancy jacket-sail.

* * *

>l
Journeying On The Waves (on the piece of wood)
A brisk westward wind is blowing. The sun hangs low in the sky over a distant island. You speed ahead toward the island as the wind catches your fancy jacket-sail.

You can see a centered positioned sail here.

>l
Journeying On The Waves (on the piece of wood)
A brisk southwestward wind is blowing. The sun hangs low in the sky over a distant island. Your speed toward the island has slowed to a crawl.

You can see a centered positioned sail here.

The wind suddenly shifts to the southwestward! Your speed toward the island has slowed to a crawl.

>turn sail left
You twist the mast slightly to the left.

>l
Journeying On The Waves (on the piece of wood)
A brisk northwestward wind is blowing. The sun hangs low in the sky over a distant island. Your speed toward the island has slowed to a crawl.

You can see a left positioned sail here.

The wind suddenly shifts to the northwestward! Your speed toward the island has slowed to a crawl.

>turn sail right
You twist the mast slightly to the right.

The wind suddenly shifts to the northwestward! Your speed toward the island has slowed to a crawl.

* * *

>turn sail right
You twist the mast slightly to the right.

>l
Journeying On The Waves (on the piece of wood)
A brisk westward wind is blowing. The sun hangs low in the sky over a distant island. Your speed toward the island has slowed to a crawl.

You can see a right positioned sail here.

The wind suddenly shifts to the westward! Your speed toward the island has slowed to a crawl.

>turn sail left
You twist the mast slightly to the left.

>look at sail
You see nothing special about the centered positioned sail.

>l
Journeying On The Waves (on the piece of wood)
A brisk northwestward wind is blowing. The sun hangs low in the sky over a distant island. Your speed toward the island has slowed to a crawl.

You can see a centered positioned sail here.

* * *

>l
Journeying On The Waves (on the piece of wood)
A brisk northwestward wind is blowing. The sun hangs low in the sky over a distant island. You speed ahead toward the island as the wind catches your fancy jacket-sail.

You can see a right positioned sail here.

>turn sail left
You twist the mast slightly to the left.

The wind suddenly shifts to the northwestward! Your speed toward the island has slowed to a crawl.

>turn sail left
You twist the mast slightly to the left.

The wind suddenly shifts to the northwestward! Your speed toward the island has slowed to a crawl.

>turn sail right
You twist the mast slightly to the right.

The wind suddenly shifts to the southwestward! Your speed toward the island has slowed to a crawl.

>turn sail left
You twist the mast slightly to the left.

>look
Journeying On The Waves (on the piece of wood)
A brisk westward wind is blowing. The sun hangs low in the sky over a distant island. Your speed toward the island has slowed to a crawl.

You can see a left positioned sail here.

>turn sail right
You twist the mast slightly to the right.

* * *

>l
Journeying On The Waves (on the piece of wood)
A brisk westward wind is blowing. The sun hangs low in the sky over a distant island. You speed ahead toward the island as the wind catches your fancy jacket-sail.

You can see a centered positioned sail here.

>l
Island Beach (on the piece of wood)
You are on a beautiful island beach.

>restart
Are you sure you want to restart?

* * *

>n
Floating Object
 You tread water to stay afloat. You're getting tired.  A body seems to have been the source of a partial meal.

On the body is a jacket.

>s
Ocean Waves
 You lay on your back in the warm water as the waves lift your body up and down rythmically.  The sun's relentless heat beats down on you and the salt spray stings your eyes. The sea laps against your face and sometimes over it.  When it does, you spout like a tiny human whale.

* * *

>w
Rippling Waves
You cling to a piece of wood.  It seems to have been part of a boat at one time..

>get jacket
You can't see any such thing.

>get on the wood
You mount the piece of wood.

>get off the wood
You dismount the piece of wood.

Rippling Waves
You cling to a piece of wood.  It seems to have been part of a boat at one time..

>get wood
You can't hold the piece of wood and swim.

>get on the wood
You mount the piece of wood.

>e
Ocean Waves (on the piece of wood)
 The water laps at the plank you sit on, rocking you up and down.  A dark object bobs up and down on the surface to the North.

* * *

>put the stick in the knothole
You place the driftwood stick into the knothole. It's a tight fit, but you manage it. Your little plank surfboard now has a mast.

>put the jacket on the stick
You drape the jacket over the stick by the collar.
The wind catches the jacket and pulls you along over the waves.

Rushing Waves (on the piece of wood)
You rush along the tops of the waves as a westward wind blows your makeshift sail.  The sail is in the center position and the wind fills it nicely. The board is slippery and wet and hits the occasional wave just so, sending a spray into your face, almost knocking you from the board. You cling to the fragile looking stick of driftwood desperately hoping that it will hold and keep you on the board.

* * *

>l
Journeying On The Waves (on the piece of wood)
A brisk southwestward wind is blowing. The sun hangs low in the sky over a distant island. Your speed toward the island has slowed to a crawl.

You can see a centered positioned sail here.

The wind suddenly shifts to the southwestward! Your speed toward the island has slowed to a crawl.

>turn sail right
You twist the mast slightly to the right.

The wind suddenly shifts to the northwestward! You speed ahead toward the island as the wind catches your fancy jacket-sail.

>l
Journeying On The Waves (on the piece of wood)
A brisk northwestward wind is blowing. The sun hangs low in the sky over a distant island. You speed ahead toward the island as the wind catches your fancy jacket-sail.

You can see a right positioned sail here.

The wind suddenly shifts to the westward! Your speed toward the island has slowed to a crawl.

>tun sail left
That's not a verb I recognise.

>turn sail left
You twist the mast slightly to the left.

>l
Journeying On The Waves (on the piece of wood)
A brisk westward wind is blowing. The sun hangs low in the sky over a distant island. You speed ahead toward the island as the wind catches your fancy jacket-sail.

You can see a centered positioned sail here.

The wind suddenly shifts to the westward! You speed ahead toward the island as the wind catches your fancy jacket-sail.

>l
Island Beach (on the piece of wood)
You are on a beautiful island beach.

* * *

>get jacket
The body is badly decayed. You can't tell if it was male or female.  Your stomach churns from the smell, but you grit your teeth and strip the jacket off.

Taken.

What next? :

>look in pocket
In pocket are a knife and a book of matches.

What next?

>get all
There are none at all available!

What next?

>get knife
Taken.

What next?

>get matches
You're carrying too many things already.

What next?

>look at knife
This is a swiss army knife with a familiar red handle. It has multiple blades and tools.

What next?

>look at matches
It's a book of twenty waterproof matches.

What next?

>light the wood with the matches
I only understood you as far as wanting to light the piece of wood.

What next?

>light the wood
This dangerous act would achieve little.

What next?

>burn the matches
This dangerous act would achieve little.

What next?

>l
Glittering Waves (on the piece of wood)
....  What is left of a human body floats on the surface here.  Something has been eating it.

What next?

>restart
Are you sure you want to restart?

* * *

>w
Rippling Waves
....  You see a piece of wood about six feet in length. You swim over and cling to it gratefully. You look at the wood, and a surge of hope goes through you. This is actually a wide board that has been roughly hewn from a log.

You can see a piece of wood here.

You think you must have hit your head against the ship during the fall, because a small raised lump on the back of your skull is throbbing.

What next?

* * *

>get jacket
The body is badly decayed. You can't tell if it was male or female.  Your stomach churns from the smell, but you grit your teeth and strip the jacket off.

Taken.

What next? :

>s
Ocean Waves (on the piece of wood)
 The water laps at the plank you sit on, rocking you up and down.

The wind suddenly shifts to the southwestward! Your speed toward the island has slowed to a crawl.

>ne
Even More Open Water (on the piece of wood)
A stick of very wet driftwood, about six feet long and and one inch thick.

The wind suddenly shifts to the southwestward! Your speed toward the island has slowed to a crawl.

>get stick
Taken.

The wind suddenly shifts to the northwestward! Your speed toward the island has slowed to a crawl.

>put stick in knothole
You place the driftwood stick into the knothole. It's tight fit but you manage it. Your little plank surfboard now has a mast.

>put jacket on stick
You drape the jacket over the stick by the collar.
The wind catches the jacket and pulls you along over the waves.

Rushing Waves (on the piece of wood)
You rush along the tops of the waves as the wind blows your makeshift sail.  The board is slippery and wet and hits the occasional wave just so, sending a spray into your face, almost knocking you from the board. You cling to the fragile looking stick of driftwood desperately hoping that it will hold and keep you on the board.

The wind suddenly shifts to the southwestward! Your speed toward the island has slowed to a crawl.

>l
Rushing Waves (on the piece of wood)
You rush along the tops of the waves as the wind blows your makeshift sail.  The board is slippery and wet and hits the occasional wave just so, sending a spray into your face, almost knocking you from the board. You cling to the fragile looking stick of driftwood desperately hoping that it will hold and keep you on the board.

>l
Journeying On The Waves (on the piece of wood)
A brisk westward wind is blowing. The sun hangs low in the sky over a distant island. You speed ahead toward the island as the wind catches your fancy jacket-sail.

You can see a centered positioned sail here.

* * *

>e
Ocean Waves (on the piece of wood)
....  The water laps at the plank you sit on, rocking you up and down. You can see a dark object bobbing on the surface to the North.

You can see bug here.

What next? :

>ne
Even More Open Water (on the piece of wood)
A stick of very wet driftwood, about six feet long and and one inch thick.

* * *

>e
Open Water (on the piece of wood)
 Nothing but more water can be seen.

>s
You can't go that way.

>n
You can't go that way.

>w
Ocean Waves (on the piece of wood)
 The water laps at the plank you sit on, rocking you up and down.

>n
Floating Object (on the piece of wood)
A body seems to have been the source of a partial meal.

On the body is a jacket.

* * *

>l
Rushing Waves
You rush along the tops of the waves as the wind blows your makeshift sail.  The board is slippery and wet and hits the occasional wave just so, sending a spray into your face, almost knocking you from the board. You cling to the fragile looking stick of driftwood desperately hoping that it will hold and keep you on the board.

You cling to a piece of wood.  It seems to have been part of a boat at one time..

>examine wood
It's a sturdy plank of the type used to make wooden hulls. There is a small knothole in the middle of it.

>examine knothole
In the knothole is a stick.

Journing On The Waves
You begin to see something peeking above the horizon of waves in the distance.

>examine wood
It's a sturdy plank of the type used to make wooden hulls. There is a small knothole in the middle of it.

>examine jacket
It's an olive-drav green military fatigue jacket with over sized pockets.

>examine stick
On the stick is a jacket.

>examine knothole
In the knothole is a stick.

* * *

>get on wood
Thank goodness!  You were getting exhausted just trying to stay a float.

You mount the piece of wood.

What next? :

>l
Rippling Waves (on the piece of wood)

* * *

>get on wood
Thank goodness!  You were getting exhausted just trying to stay a float.

You mount the piece of wood.

What next? :

>ne
Glittering Waves (on the piece of wood)
....  What is left of a human body floats on the surface here.  Something has been eating it.

On the body is a jacket.

>e
Ocean Waves (on the piece of wood)
 The water laps at the plank you sit on, rocking you up and down.  A dark object bobs up and down on the surface to the North.

* * *

>ne
Glittering Waves (on the piece of wood)
....  What is left of a human body floats on the surface here.  Something has been eating it.

On the body is a jacket.

>get all
jacket: The body is badly decayed. You can't tell if it was male or female.  Your stomach churns from the smell, but you grit your teeth and strip the jacket off.

Taken.
knife: Taken.

>e
Even More Open Water (on the piece of wood)
....  There is a stick of very wet driftwood here, about six feet long and and one inch thick.

>get all
stick: Taken.

* * *

>put stick in hole
You place the driftwood stick into the knothole. It's a tight fit, but you manage it. Your little plank surfboard now has a mast.

>put jacke on stick
You can't see any such thing.

>put jacket on stick
You drape the jacket over the stick by the collar.
The wind catches the jacket and pulls you along over the waves.

Rushing Waves (on the piece of wood)
You rush along the tops of the waves as a westward wind blows your makeshift sail.  The sail is in the center position and the wind fills it nicely. The board is slippery and wet and hits the occasional wave just so, sending a spray into your face, almost knocking you from the board. You cling to the fragile looking stick of driftwood desperately hoping that it will hold and keep you on the board.

* * *

>l
Journeying On The Waves (on the piece of wood)
A brisk westward wind is blowing. The sun hangs low in the sky. You speed ahead toward the island as the wind catches your fancy jacket-sail.

You can see a centered positioned sail here.

The wind suddenly shifts to the westward! You speed ahead toward the island as the wind catches your fancy jacket-sail.There is the faint outline of an island in the distance.

>l
Journeying On The Waves (on the piece of wood)
A brisk westward wind is blowing. The sun hangs low in the sky. You speed ahead toward the island as the wind catches your fancy jacket-sail.

You can see a centered positioned sail here.

The wind suddenly shifts to the northwestward! Your speed toward the island has slowed to a crawl.There is the faint outline of an island in the distance.

>l
Journeying On The Waves (on the piece of wood)
A brisk northwestward wind is blowing. The sun hangs low in the sky. Your speed toward the island has slowed to a crawl.

You can see a centered positioned sail here.

>turn sail right
You twist the mast slightly to the right.
centered positioned sail

>l
Journeying On The Waves (on the piece of wood)
A brisk westward wind is blowing. The sun hangs low in the sky. Your speed toward the island has slowed to a crawl.

You can see a right positioned sail here.

The wind suddenly shifts to the westward! Your speed toward the island has slowed to a crawl.

>turn sail left
You twist the mast slightly to the left.
right positioned sail
The island is getting closer.

>l
Journeying On The Waves (on the piece of wood)
A brisk westward wind is blowing. The sun hangs low in the sky. You speed ahead toward the island as the wind catches your fancy jacket-sail.

You can see a centered positioned sail here.

The island is getting closer.

* * *

>l
Journeying On The Waves (on the piece of wood)
A brisk westward wind is blowing. The sun hangs low in the sky. You speed ahead toward the island as the wind catches your fancy jacket-sail.

You can see a centered positioned sail here.

>l
Journeying On The Waves (on the piece of wood)
A brisk westward wind is blowing. The sun hangs low in the sky. You speed ahead toward the island as the wind catches your fancy jacket-sail.

You can see a centered positioned sail here.

The wind suddenly shifts to the westward! You speed ahead toward the island as the wind catches your fancy jacket-sail.You've almost made it to the island.

>l
Journeying On The Waves (on the piece of wood)
A brisk westward wind is blowing. The sun hangs low in the sky. You speed ahead toward the island as the wind catches your fancy jacket-sail.

You can see a centered positioned sail here.

You've almost made it to the island.

>l
Journeying On The Waves (on the piece of wood)
A brisk southwestward wind is blowing. The sun hangs low in the sky. Your speed toward the island has slowed to a crawl.

You can see a centered positioned sail here.

You've almost made it to the island.

>turn sail left
You twist the mast slightly to the left.
centered positioned sail
You've almost made it to the island.

>l
Journeying On The Waves (on the piece of wood)
A brisk southwestward wind is blowing. The sun hangs low in the sky. You speed ahead toward the island as the wind catches your fancy jacket-sail.

You can see a left positioned sail here.

The wind suddenly shifts to the southwestward! You speed ahead toward the island as the wind catches your fancy jacket-sail.You've almost made it to the island.

>l
Journeying On The Waves (on the piece of wood)
A brisk southwestward wind is blowing. The sun hangs low in the sky. You speed ahead toward the island as the wind catches your fancy jacket-sail.

You can see a left positioned sail here.

You've almost made it to the island.

>l
Journeying On The Waves (on the piece of wood)
A brisk westward wind is blowing. The sun hangs low in the sky. Your speed toward the island has slowed to a crawl.

You can see a left positioned sail here.

You've almost made it to the island.

>l
Journeying On The Waves (on the piece of wood)
A brisk westward wind is blowing. The sun hangs low in the sky. Your speed toward the island has slowed to a crawl.

You can see a left positioned sail here.

You've almost made it to the island.

>turn sail right
You twist the mast slightly to the right.
left positioned sail

>l
Island Beach (on the piece of wood)
You are on a beautiful island beach. To the east there is nothing but ocean for as far as the eye can see. The white sand beach extends north and south.  To the west is a lush jungle of green vegetation.

* * *

>n
North Beach (on the piece of wood)

>n
You can't go that way.

>s
Island Beach (on the piece of wood)
You are on a beautiful island beach. To the east there is nothing but ocean for as far as the eye can see. The white sand beach extends north and south.  To the west is a lush jungle of green vegetation.

>s
South Beach (on the piece of wood)

>n
Island Beach (on the piece of wood)
You are on a beautiful island beach. To the east there is nothing but ocean for as far as the eye can see. The white sand beach extends north and south.  To the west is a lush jungle of green vegetation.

>save
Please supply a filename for save
Ok.

* * *

>put stick in hole
You place the driftwood stick into the knothole. It's a tight fit, but you manage it. Your little plank surfboard now has a mast.

>put jacket on sail
You can't see any such thing.

>put jacket on stick
You drape the jacket over the stick by the collar.
The wind catches the jacket and pulls you along over the waves.

Rushing Waves (on the piece of wood)
You rush along the tops of the waves as a westward wind blows your makeshift sail.  The sail is in the center position and the wind fills it nicely. The board is slippery and wet and hits the occasional wave just so, sending a spray into your face, almost knocking you from the board. You cling to the fragile looking stick of driftwood desperately hoping that it will hold and keep you on the board.

* * *

>l
Journeying On The Waves (on the piece of wood)
A brisk wind wind is blowing. The sun hangs low in the sky. In the distance you can barely make out the shape of an island jutting above the waves

You can see a sail here.

The wind suddenly shifts to the westward! You speed ahead toward the island as the wind catches your fancy jacket-sail.There is the faint outline of an island in the distance.

>turn the mast left
You twist the mast slightly to the left.
centered positioned sail
There is the faint outline of an island in the distance.

* * *

>put jacket on stick
You drape the jacket over the stick by the collar.
The wind catches the jacket and pulls you along over the waves.

Rushing Waves (on the piece of wood)
You rush along the tops of the waves as a westward wind blows your makeshift sail.  The sail is in the center position and the wind fills it nicely. The board is slippery and wet and hits the occasional wave just so, sending a spray into your face, almost knocking you from the board. You cling to the fragile looking stick of driftwood desperately hoping that it will hold and keep you on the board.

>w
You begin to paddle in that direction but without a plan or destination you soon lose hope and return.

>l
Journeying On The Waves (on the piece of wood)
A brisk wind wind is blowing. The sun hangs low in the sky. In the distance you can barely make out the shape of an island jutting above the waves

You can see a sail here.

The wind suddenly shifts to the westward! You speed ahead toward the island as the wind catches your fancy jacket-sail.There is the faint outline of an island in the distance.

* * *

>l
Journeying On The Waves (on the piece of wood)
A brisk northwestward wind is blowing. The sun hangs low in the sky. Your speed toward the island has slowed to a crawl.

You can see a centered positioned sail here.

There is the faint outline of an island in the distance.

>l
Journeying On The Waves (on the piece of wood)
A brisk westward wind is blowing. The sun hangs low in the sky. You speed ahead toward the island as the wind catches your fancy jacket-sail.

You can see a centered positioned sail here.

The wind suddenly shifts to the westward! You speed ahead toward the island as the wind catches your fancy jacket-sail.

* * *

>l
Journeying On The Waves (on the piece of wood)
A brisk westward wind is blowing. The sun hangs low in the sky. You speed ahead toward the island as the wind catches your fancy jacket-sail.

You can see a centered positioned sail here.

>turn sail left
You twist the mast slightly to the left.
centered positioned sail
The wind suddenly shifts to the southwestward! You speed ahead toward the island as the wind catches your fancy jacket-sail.The island is getting closer.

>l
Journeying On The Waves (on the piece of wood)
A brisk southwestward wind is blowing. The sun hangs low in the sky. You speed ahead toward the island as the wind catches your fancy jacket-sail.

You can see a left positioned sail here.

The island is getting closer.

>l
Journeying On The Waves (on the piece of wood)
A brisk northwestward wind is blowing. The sun hangs low in the sky. Your speed toward the island has slowed to a crawl.

You can see a left positioned sail here.

The island is getting closer.

>l
Journeying On The Waves (on the piece of wood)
A brisk northwestward wind is blowing. The sun hangs low in the sky. Your speed toward the island has slowed to a crawl.

You can see a left positioned sail here.

The island is getting closer.

>l
Journeying On The Waves (on the piece of wood)
A brisk northwestward wind is blowing. The sun hangs low in the sky. Your speed toward the island has slowed to a crawl.

You can see a left positioned sail here.

The wind suddenly shifts to the northwestward! Your speed toward the island has slowed to a crawl.The island is getting closer.

>l
Journeying On The Waves (on the piece of wood)
A brisk northwestward wind is blowing. The sun hangs low in the sky. Your speed toward the island has slowed to a crawl.

You can see a left positioned sail here.

The wind suddenly shifts to the westward! Your speed toward the island has slowed to a crawl.The island is getting closer.

>l
Journeying On The Waves (on the piece of wood)
A brisk westward wind is blowing. The sun hangs low in the sky. Your speed toward the island has slowed to a crawl.

You can see a left positioned sail here.

The island is getting closer.

>l
Journeying On The Waves (on the piece of wood)
A brisk southwestward wind is blowing. The sun hangs low in the sky. You speed ahead toward the island as the wind catches your fancy jacket-sail.

You can see a left positioned sail here.

>n
You begin to paddle, but it has little effect. Better stick to sailing.

The wind suddenly shifts to the southwestward! You speed ahead toward the island as the wind catches your fancy jacket-sail.You've almost made it to the island.

>s
You begin to paddle, but it has little effect. Better stick to sailing.

You've almost made it to the island.

>turn sail left
You twist the mast slightly to the left.
left positioned sail
The wind suddenly shifts to the southwestward! Your speed toward the island has slowed to a crawl.You've almost made it to the island.

>l
Journeying On The Waves (on the piece of wood)
A brisk southwestward wind is blowing. The sun hangs low in the sky. Your speed toward the island has slowed to a crawl.

You can see a left positioned sail here.

The wind suddenly shifts to the westward! Your speed toward the island has slowed to a crawl.You've almost made it to the island.

A grey fin emerges from the waves.  Your adrenaline kicks in, but you manage to hold yourself together.  You guide your make-shift sailboard away from it until the fin submerges.

>turn sail right
You twist the mast slightly to the right.
left positioned sail
The wind suddenly shifts to the westward! Your speed toward the island has slowed to a crawl.You've almost made it to the island.

A grey fin emerges from the waves.  Your adrenaline kicks in, but you manage to hold yourself together.  You guide your make-shift sailboard away from it until the fin submerges.

>turn sail right
You twist the mast slightly to the right.
left positioned sail
You've almost made it to the island.

A grey fin emerges from the waves.  Your adrenaline kicks in, but you manage to hold yourself together.  You guide your make-shift sailboard away from it until the fin submerges.

>l
Journeying On The Waves (on the piece of wood)
A brisk northwestward wind is blowing. The sun hangs low in the sky. Your speed toward the island has slowed to a crawl.

You can see a centered positioned sail here.

You've almost made it to the island.

A grey fin emerges from the waves.  Your adrenaline kicks in, but you manage to hold yourself together.  You guide your make-shift sailboard away from it until the fin submerges.

>turn sail right
You twist the mast slightly to the right.
centered positioned sail
You've almost made it to the island.

A grey fin emerges from the waves.  Your adrenaline kicks in, but you manage to hold yourself together.  You guide your make-shift sailboard away from it until the fin submerges.
The shark is too quick.  Eons of evolution has turned it into the perfect predator.  It smells your fear and in the blink of an eye it's over.

    *** You have been eaten. ***

Would you like to RESTART, RESTORE a saved game, QUIT or UNDO the last command?

* * *

>get all
stick: Taken.

>put stick in wood
That can't contain things.

>put stick in hole
You place the driftwood stick into the knothole. It's a tight fit, but you manage it. Your little plank surfboard now has a mast.

* * *

>l
Journeying On The Waves (on the piece of wood)
A brisk wind wind is blowing. The sun hangs low in the sky. In the distance you can barely make out the shape of an island jutting above the waves

You can see a sail here.

There is the faint outline of an island in the distance.

>l
Journeying On The Waves (on the piece of wood)
A brisk westward wind is blowing. The sun hangs low in the sky. You speed ahead toward the island as the wind catches your fancy jacket-sail.

You can see a centered positioned sail here.

There is the faint outline of an island in the distance.

* * *

>l
Journeying On The Waves (on the piece of wood)
A brisk westward wind is blowing. The sun hangs low in the sky. You speed ahead toward the island as the wind catches your fancy jacket-sail.

You can see a centered positioned sail here.

>turn sail left
You twist the mast slightly to the left.
centered positioned sail

>l
Journeying On The Waves (on the piece of wood)
A brisk westward wind is blowing. The sun hangs low in the sky. Your speed toward the island has slowed to a crawl.

You can see a left positioned sail here.

>turn sail right
You twist the mast slightly to the right.
left positioned sail
The island is getting closer.

>l
Journeying On The Waves (on the piece of wood)
A brisk westward wind is blowing. The sun hangs low in the sky. You speed ahead toward the island as the wind catches your fancy jacket-sail.

You can see a centered positioned sail here.

The island is getting closer.

* * *

>l
Journeying On The Waves (on the piece of wood)
A brisk westward wind is blowing. The sun hangs low in the sky. You speed ahead toward the island as the wind catches your fancy jacket-sail.

You can see a centered positioned sail here.

The wind suddenly shifts to the westward! You speed ahead toward the island as the wind catches your fancy jacket-sail.You've almost made it to the island.

>l
Journeying On The Waves (on the piece of wood)
A brisk westward wind is blowing. The sun hangs low in the sky. You speed ahead toward the island as the wind catches your fancy jacket-sail.

You can see a centered positioned sail here.

The wind suddenly shifts to the westward! You speed ahead toward the island as the wind catches your fancy jacket-sail.You've almost made it to the island.

>l
Journeying On The Waves (on the piece of wood)
A brisk westward wind is blowing. The sun hangs low in the sky. You speed ahead toward the island as the wind catches your fancy jacket-sail.

You can see a centered positioned sail here.

The wind suddenly shifts to the southwestward! Your speed toward the island has slowed to a crawl.You've almost made it to the island.

>turn sail right
You twist the mast slightly to the right.
centered positioned sail
You've almost made it to the island.

>turn sail right
You twist the mast slightly to the right.
right positioned sail
The wind suddenly shifts to the westward! Your speed toward the island has slowed to a crawl.You've almost made it to the island.

>l
Journeying On The Waves (on the piece of wood)
A brisk westward wind is blowing. The sun hangs low in the sky. Your speed toward the island has slowed to a crawl.

You can see a right positioned sail here.

You've almost made it to the island.

>turn sail left
You twist the mast slightly to the left.
right positioned sail
You've almost made it to the island.

>l
Journeying On The Waves (on the piece of wood)
A brisk northwestward wind is blowing. The sun hangs low in the sky. You speed ahead toward the island as the wind catches your fancy jacket-sail.

You can see a right positioned sail here.

>restart
Are you sure you want to restart?

* * *

>l
Island Beach (on the piece of wood)
You are on a beautiful island beach. To the east there is nothing but ocean for as far as the eye can see. The white sand beach extends north and south.  The west is a lush jungle of green vegetation.

A grey fin emerges from the waves.  Your adrenaline kicks in, but you manage to hold yourself together.  You guide your make-shift sailboard away from it until the fin submerges.

* * *

>e
Even More Open Water (on the piece of wood)
....  There is a stick of very wet driftwood here, about six feet long and and one inch thick.

>get stick
You're carrying too many things already.

>put knife in pocket
You put the knife into pocket.

* * *

>put stick in hole
You place the driftwood stick into the knothole. It's a tight fit, but you manage it. Your little plank surfboard now has a mast.

>put jacket on stick
You drape the jacket over the stick by the collar.
The wind catches the jacket and pulls you along over the waves.

Journeying On The Waves (on the piece of wood)
.... A brisk westward wind is blowing and the sun hangs low in the sky. In the distance you can barely make out the shape of an island jutting above the waves

You can see a centered positioned sail here.

Wind is 2 and sail is 2 and the island is 0.
A westward wind continues to blow.
There is the faint outline of an island in the distance.

>l
Journeying On The Waves (on the piece of wood)
.... A brisk westward wind is blowing and the sun hangs low in the sky. You speed ahead toward the island as the wind catches your centered positioned sail.

Wind is 2 and sail is 2 and the island is 0.
A westward wind continues to blow.
There is the faint outline of an island in the distance.

>l
White Sand Beach (on the piece of wood)
.... You are on a beautiful island beach. To the east there is nothing but ocean for as far as the eye can see. This white sand beach extends north and south.  To the west is a lush jungle of green vegetation.

>north
You can't sail on land. You should probably get off the board.

>get off bored
You dismount the piece of wood.

White Sand Beach
.... You are on a beautiful island beach. To the east there is nothing but ocean for as far as the eye can see. This white sand beach extends north and south.  To the west is a lush jungle of green vegetation.

You can see a piece of wood here.

>n
North Beach
.... You are on the beach a little north from where you came ashore.  You can see your sailboard to the south. The palm trees whisper in the wind to the west in the lush jungle.

You can see a Sea Turtle here.

>look at Sea Turtle
The Sea Turtle is about four feet around and has a colorful dark green shell. Her flippered legs propel her forward as she shuffles accross the beach toward a low sandy mound near the tree line to the west. She turns a large intelligent eye at you for a few seconds, but then continues laboring toward the mound.

>attack sea turtle
Violence isn't the answer to this one.

>get on turtle
The turtle cranes it neck back and snaps menacingly at you. It is will not allow you to ride.

>w
The Sea Turtle swivels quickly toward you, snapping its curved beak at the air inches from your exposed legs. You stagger back in fear for your life.

* * *

>ne
Glittering Waves (on the piece of wood)
....  What is left of a human body floats on the surface here.  Something has been eating it.

On the body is a jacket.

>get jacket
The body is badly decayed. You can't tell if it was male or female.  Your stomach churns from the smell, but you grit your teeth and strip the jacket off.

>e
Even More Open Water (on the piece of wood)
....  There is a stick of very wet driftwood here, about six feet long and and one inch thick.

>get jacket
You already have that.

* * *

>get stick
Taken.

>put stick in knothole
You place the driftwood stick into the knothole. It's a tight fit, but you manage it. Your little plank surfboard now has a mast.

>put jacket on stcik
You can't see any such thing.

>put jacket on stick
You drape the jacket over the stick by the collar.
The wind catches the jacket and pulls you along over the waves.

Rushing Waves (on the piece of wood)
You rush along the tops of the waves as a westward wind blows your makeshift sail.  The sail is in the center position and the wind fills it nicely. The board is slippery and wet and hits the occasional wave just so, sending a spray into your face, almost knocking you from the board. You cling to the fragile looking stick of driftwood desperately hoping that it will hold and keep you on the board.

* * *

>l
Journeying On The Waves (on the piece of wood)
A brisk wind wind is blowing. The sun hangs low in the sky. In the distance you can barely make out the shape of an island jutting above the waves

You can see a sail here.

There is the faint outline of an island in the distance.

>w
You begin to paddle, but it has little effect. Better stick to sailing.

There is the faint outline of an island in the distance.

>l
Journeying On The Waves (on the piece of wood)
A brisk westward wind is blowing. The sun hangs low in the sky. You speed ahead toward the island as the wind catches your fancy jacket-sail.

You can see a centered positioned sail here.

>l
Journeying On The Waves (on the piece of wood)
A brisk westward wind is blowing. The sun hangs low in the sky. You speed ahead toward the island as the wind catches your fancy jacket-sail.

You can see a centered positioned sail here.

The wind suddenly shifts to the westward! You speed ahead toward the island as the wind catches your fancy jacket-sail.The island getting closer.

>l
Journeying On The Waves (on the piece of wood)
A brisk westward wind is blowing. The sun hangs low in the sky. You speed ahead toward the island as the wind catches your fancy jacket-sail.

You can see a centered positioned sail here.

The wind suddenly shifts to the southwestward! Your speed toward the island has slowed to a crawl.The island getting closer.

>turn sail left
You twist the mast slightly to the left.
centered positioned sail
The island getting closer.

>l
Journeying On The Waves (on the piece of wood)
A brisk southwestward wind is blowing. The sun hangs low in the sky. You speed ahead toward the island as the wind catches your fancy jacket-sail.

You can see a left positioned sail here.

The wind suddenly shifts to the southwestward! You speed ahead toward the island as the wind catches your fancy jacket-sail.

>l
Journeying On The Waves (on the piece of wood)
A brisk southwestward wind is blowing. The sun hangs low in the sky. You speed ahead toward the island as the wind catches your fancy jacket-sail.

You can see a left positioned sail here.

You've almost made it to the island.

>l
Journeying On The Waves (on the piece of wood)
A brisk southwestward wind is blowing. The sun hangs low in the sky. You speed ahead toward the island as the wind catches your fancy jacket-sail.

You can see a left positioned sail here.

You've almost made it to the island.

>l
Journeying On The Waves (on the piece of wood)
A brisk southwestward wind is blowing. The sun hangs low in the sky. You speed ahead toward the island as the wind catches your fancy jacket-sail.

You can see a left positioned sail here.

The wind suddenly shifts to the southwestward! You speed ahead toward the island as the wind catches your fancy jacket-sail.You've almost made it to the island.

>l
Journeying On The Waves (on the piece of wood)
A brisk southwestward wind is blowing. The sun hangs low in the sky. You speed ahead toward the island as the wind catches your fancy jacket-sail.

You can see a left positioned sail here.

The wind suddenly shifts to the southwestward! You speed ahead toward the island as the wind catches your fancy jacket-sail.

>l
Island Beach (on the piece of wood)
You are on a beautiful island beach.

I beg your pardon?

>quit
Are you sure you want to quit?

* * *

>e
Even More Open Water (on the piece of wood)
....  There is a stick of very wet driftwood here, about six feet long and and one inch thick.

>get stick
Taken.

>look
Even More Open Water (on the piece of wood)

>put stick in hole
You place the driftwood stick into the knothole. It's a tight fit, but you manage it. Your little plank surfboard now has a mast.

>put jacket on stick
You drape the jacket over the stick by the collar.
The wind catches the jacket and pulls you along over the waves.

Journeying On The Waves (on the piece of wood)
.... A brisk westward wind is blowing and the sun hangs low in the sky. In the distance you can barely make out the shape of an island jutting above the waves

You can see a centered positioned sail here.

There is the faint outline of an island in the distance.

>w
You begin to paddle, but it has little effect. Better stick to sailing. You watch the wind pushing the sail to see if you need to turn it left or right.

The wind suddenly shifts to a northwestward wind!
There is the faint outline of an island in the distance.

>w
You begin to paddle, but it has little effect. Better stick to sailing. You watch the wind pushing the sail to see if you need to turn it left or right.

The wind suddenly shifts to a southwestward wind!
There is the faint outline of an island in the distance.

>look
Journeying On The Waves (on the piece of wood)
.... A brisk southwestward wind is blowing and the sun hangs low in the sky. Your speed toward the island has slowed to a crawl.

You can see a centered positioned sail here.

A southwestward wind continues to blow.
There is the faint outline of an island in the distance.

>look
Journeying On The Waves (on the piece of wood)
.... A brisk southwestward wind is blowing and the sun hangs low in the sky. Your speed toward the island has slowed to a crawl.

You can see a centered positioned sail here.

There is the faint outline of an island in the distance.

>look
Journeying On The Waves (on the piece of wood)
.... A brisk southwestward wind is blowing and the sun hangs low in the sky. Your speed toward the island has slowed to a crawl.

You can see a centered positioned sail here.

The wind suddenly shifts to a northwestward wind!
There is the faint outline of an island in the distance.

>look
Journeying On The Waves (on the piece of wood)
.... A brisk northwestward wind is blowing and the sun hangs low in the sky. Your speed toward the island has slowed to a crawl.

You can see a centered positioned sail here.

There is the faint outline of an island in the distance.

>look
Journeying On The Waves (on the piece of wood)
.... A brisk northwestward wind is blowing and the sun hangs low in the sky. Your speed toward the island has slowed to a crawl.

You can see a centered positioned sail here.

There is the faint outline of an island in the distance.

>look
Journeying On The Waves (on the piece of wood)
.... A brisk northwestward wind is blowing and the sun hangs low in the sky. Your speed toward the island has slowed to a crawl.

You can see a centered positioned sail here.

The wind suddenly shifts to a southwestward wind!
There is the faint outline of an island in the distance.

>look
Journeying On The Waves (on the piece of wood)
.... A brisk southwestward wind is blowing and the sun hangs low in the sky. Your speed toward the island has slowed to a crawl.

You can see a centered positioned sail here.

There is the faint outline of an island in the distance.

>look
Journeying On The Waves (on the piece of wood)
.... A brisk southwestward wind is blowing and the sun hangs low in the sky. Your speed toward the island has slowed to a crawl.

You can see a centered positioned sail here.

The wind suddenly shifts to a westward wind!
There is the faint outline of an island in the distance.

>look
Journeying On The Waves (on the piece of wood)
.... A brisk westward wind is blowing and the sun hangs low in the sky. You speed ahead toward the island as the wind catches your centered positioned sail.

>look
Journeying On The Waves (on the piece of wood)
.... A brisk westward wind is blowing and the sun hangs low in the sky. You speed ahead toward the island as the wind catches your centered positioned sail.

The island is getting closer.

>turn sail left
You twist the mast slightly to the left.

The wind suddenly shifts to a southwestward wind!
The island is getting closer.

>l
Journeying On The Waves (on the piece of wood)
.... A brisk southwestward wind is blowing and the sun hangs low in the sky. You speed ahead toward the island as the wind catches your left positioned sail.

>look
Journeying On The Waves (on the piece of wood)
.... A brisk southwestward wind is blowing and the sun hangs low in the sky. You speed ahead toward the island as the wind catches your left positioned sail.

The wind suddenly shifts to a westward wind!

>look
Journeying On The Waves (on the piece of wood)
.... A brisk westward wind is blowing and the sun hangs low in the sky. Your speed toward the island has slowed to a crawl.

You can see a left positioned sail here.

The wind suddenly shifts to a northwestward wind!

A grey fin emerges from the waves. Adrenaline kicks in, but you manage to hold yourself together.  You guide your make-shift sailboard away from the creature until the fin submerges. For a moment you feel somewhat relieved, and then you wonder where the creature has gone to.

>look
Journeying On The Waves (on the piece of wood)
.... A brisk northwestward wind is blowing and the sun hangs low in the sky. Your speed toward the island has slowed to a crawl.

You can see a left positioned sail here.

A grey fin emerges from the waves. Adrenaline kicks in, but you manage to hold yourself together.  You guide your make-shift sailboard away from the creature until the fin submerges. For a moment you feel somewhat relieved, and then you wonder where the creature has gone to.

>look
Journeying On The Waves (on the piece of wood)
.... A brisk northwestward wind is blowing and the sun hangs low in the sky. Your speed toward the island has slowed to a crawl.

You can see a left positioned sail here.

A grey fin emerges from the waves. Adrenaline kicks in, but you manage to hold yourself together.  You guide your make-shift sailboard away from the creature until the fin submerges. For a moment you feel somewhat relieved, and then you wonder where the creature has gone to.

>turn sail left
You twist the mast slightly to the left.

A grey fin emerges from the waves. Adrenaline kicks in, but you manage to hold yourself together.  You guide your make-shift sailboard away from the creature until the fin submerges. For a moment you feel somewhat relieved, and then you wonder where the creature has gone to.

* * *

>put stick in hole
You place the driftwood stick into the knothole. It's a tight fit, but you manage it. Your little plank surfboard now has a mast.

>l
Even More Open Water (on the piece of wood)

>l
Even More Open Water (on the piece of wood)

>put jacket on stick
You drape the jacket over the stick by the collar.
The wind catches the jacket and pulls you along over the waves.

Journeying On The Waves (on the piece of wood)
A brisk wind is blowing and the sun hangs low in the sky. In the distance you can barely make out the shape of an island jutting above the waves

You can see a sail here.

old wind direction was 2 new direction is 1The wind suddenly shifts to a southwestward wind!
There is the faint outline of an island in the distance.

>l
Journeying On The Waves (on the piece of wood)
A brisk southwestward wind is blowing and the sun hangs low in the sky. You speed ahead toward the island as the wind catches your fancy jacket-sail.

You can see a centered positioned sail here.

There is the faint outline of an island in the distance.

>l
Journeying On The Waves (on the piece of wood)
A brisk southwestward wind is blowing and the sun hangs low in the sky. Your speed toward the island has slowed to a crawl.

You can see a centered positioned sail here.

old wind direction was 1 new direction is 3The wind suddenly shifts to a northwestward wind!
There is the faint outline of an island in the distance.

* * *

>put stick in hole
You place the driftwood stick into the knothole. It's a tight fit, but you manage it. Your little plank surfboard now has a mast.

>put jacket on stick
You drape the jacket over the stick by the collar.
The wind catches the jacket and pulls you along over the waves.

Journeying On The Waves (on the piece of wood)
A brisk westward wind is blowing and the sun hangs low in the sky. In the distance you can barely make out the shape of an island jutting above the waves

You can see a centered positioned sail here.

The wind suddenly shifts to a southwestward wind!
There is the faint outline of an island in the distance.

>l
Journeying On The Waves (on the piece of wood)
A brisk southwestward wind is blowing and the sun hangs low in the sky. Your speed toward the island has slowed to a crawl.

You can see a centered positioned sail here.

A southwestward wind continues to blow.
There is the faint outline of an island in the distance.

>l
Journeying On The Waves (on the piece of wood)
A brisk southwestward wind is blowing and the sun hangs low in the sky. Your speed toward the island has slowed to a crawl.

You can see a centered positioned sail here.

There is the faint outline of an island in the distance.

>l
Journeying On The Waves (on the piece of wood)
A brisk southwestward wind is blowing and the sun hangs low in the sky. Your speed toward the island has slowed to a crawl.

You can see a centered positioned sail here.

A southwestward wind continues to blow.
There is the faint outline of an island in the distance.

* * *

>l
Journeying On The Waves (on the piece of wood)
A brisk southwestward wind is blowing and the sun hangs low in the sky. Your speed toward the island has slowed to a crawl.

You can see a centered positioned sail here.

There is the faint outline of an island in the distance.

>l
Journeying On The Waves (on the piece of wood)
A brisk southwestward wind is blowing and the sun hangs low in the sky. Your speed toward the island has slowed to a crawl.

You can see a centered positioned sail here.

There is the faint outline of an island in the distance.

>l
Journeying On The Waves (on the piece of wood)
A brisk southwestward wind is blowing and the sun hangs low in the sky. Your speed toward the island has slowed to a crawl.

You can see a centered positioned sail here.

The wind suddenly shifts to a westward wind!
There is the faint outline of an island in the distance.

>l
Journeying On The Waves (on the piece of wood)
A brisk westward wind is blowing and the sun hangs low in the sky. You speed ahead toward the island as the wind catches your fancy jacket-sail.

You can see a centered positioned sail here.

There is the faint outline of an island in the distance.

* * *

>l
Journeying On The Waves (on the piece of wood)
A brisk westward wind is blowing and the sun hangs low in the sky. You speed ahead toward the island as the wind catches your fancy jacket-sail.

You can see a centered positioned sail here.

>l
Journeying On The Waves (on the piece of wood)
A brisk westward wind is blowing and the sun hangs low in the sky. You speed ahead toward the island as the wind catches your fancy jacket-sail.

You can see a centered positioned sail here.

The wind suddenly shifts to a northwestward wind!

>l
Journeying On The Waves (on the piece of wood)
A brisk northwestward wind is blowing and the sun hangs low in the sky. Your speed toward the island has slowed to a crawl.

You can see a centered positioned sail here.

The wind suddenly shifts to a southwestward wind!

>l
Journeying On The Waves (on the piece of wood)
A brisk southwestward wind is blowing and the sun hangs low in the sky. Your speed toward the island has slowed to a crawl.

You can see a centered positioned sail here.

>l
Journeying On The Waves (on the piece of wood)
A brisk southwestward wind is blowing and the sun hangs low in the sky. Your speed toward the island has slowed to a crawl.

You can see a centered positioned sail here.

The wind suddenly shifts to a westward wind!
The island is getting closer.

>l
Journeying On The Waves (on the piece of wood)
A brisk westward wind is blowing and the sun hangs low in the sky. You speed ahead toward the island as the wind catches your fancy jacket-sail.

You can see a centered positioned sail here.

The wind suddenly shifts to a southwestward wind!
The island is getting closer.

A grey fin emerges from the waves. Adrenaline kicks in, but you manage to hold yourself together.  You guide your make-shift sailboard away from the creature until the fin submerges. For a moment you feel somewhat relieved, and then you wonder where the creature has gone to.

>l
Journeying On The Waves (on the piece of wood)
A brisk southwestward wind is blowing and the sun hangs low in the sky. Your speed toward the island has slowed to a crawl.

You can see a centered positioned sail here.

The wind suddenly shifts to a northwestward wind!
The island is getting closer.

A grey fin emerges from the waves. Adrenaline kicks in, but you manage to hold yourself together.  You guide your make-shift sailboard away from the creature until the fin submerges. For a moment you feel somewhat relieved, and then you wonder where the creature has gone to.

>l
Journeying On The Waves (on the piece of wood)
A brisk northwestward wind is blowing and the sun hangs low in the sky. Your speed toward the island has slowed to a crawl.

You can see a centered positioned sail here.

The island is getting closer.

A grey fin emerges from the waves. Adrenaline kicks in, but you manage to hold yourself together.  You guide your make-shift sailboard away from the creature until the fin submerges. For a moment you feel somewhat relieved, and then you wonder where the creature has gone to.

>l
Journeying On The Waves (on the piece of wood)
A brisk northwestward wind is blowing and the sun hangs low in the sky. Your speed toward the island has slowed to a crawl.

You can see a centered positioned sail here.

The island is getting closer.

A grey fin emerges from the waves. Adrenaline kicks in, but you manage to hold yourself together.  You guide your make-shift sailboard away from the creature until the fin submerges. For a moment you feel somewhat relieved, and then you wonder where the creature has gone to.

>l
Journeying On The Waves (on the piece of wood)
A brisk northwestward wind is blowing and the sun hangs low in the sky. Your speed toward the island has slowed to a crawl.

You can see a centered positioned sail here.

The island is getting closer.

A grey fin emerges from the waves. Adrenaline kicks in, but you manage to hold yourself together.  You guide your make-shift sailboard away from the creature until the fin submerges. For a moment you feel somewhat relieved, and then you wonder where the creature has gone to.
Suddenly the shark reappears next to your board.  This time it is too quick.  Eons of evolution has turned it into the perfect predator. You look over and see a big toothy grin. You imagine he's your pal, just surfing along with you on the waves, having a good time. It's easier that way.  The end comes in a blink of eye.

    *** You have been eaten. ***

Would you like to RESTART, RESTORE a saved game, QUIT or UNDO the last command?

>l
White Sand Beach (on the piece of wood)
You are on a beautiful island beach. To the east there is nothing but ocean for as far as the eye can see. This white sand beach extends north and south.  To the west is a lush jungle of green vegetation.

* * *

>l
Journeying On The Waves (on the piece of wood)
A brisk southwestward wind is blowing and the sun hangs low in the sky. Your speed toward the island has slowed to a crawl.

You can see a centered positioned sail here.

There is the faint outline of an island in the distance.

>turn sail right
You twist the mast slightly to the right.
A brisk southwestward wind is blowing and the sun hangs low in the sky. Your speed toward the island has slowed to a crawl.
A southwestward wind continues to blow. You speed ahead toward the island as the wind catches your fancy jacket-sail.

* * *

>l
Journeying On The Waves (on the piece of wood)
A brisk southwestward wind is blowing and the sun hangs low in the sky. Your speed toward the island has slowed to a crawl.

You can see a centered positioned sail here.

A southwestward wind continues to blow.
There is the faint outline of an island in the distance.

>turn sail left
You twist the mast slightly to the left.

The island is getting closer.

>l
Journeying On The Waves (on the piece of wood)
A brisk westward wind is blowing and the sun hangs low in the sky. Your speed toward the island has slowed to a crawl.

You can see a right positioned sail here.

The island is getting closer.

>turn sail left
You twist the mast slightly to the left.

The island is getting closer.

* * *

>l
Journeying On The Waves (on the piece of wood)
A brisk wind wind is blowing. The sun hangs low in the sky. In the distance you can barely make out the shape of an island jutting above the waves

You can see a sail here.

There is the faint outline of an island in the distance.

>l
Journeying On The Waves (on the piece of wood)
A brisk westward wind is blowing. The sun hangs low in the sky. You speed ahead toward the island as the wind catches your fancy jacket-sail.

You can see a centered positioned sail here.

There is a faint outline of an island in the distance.

>turn sail right.
I only understood you as far as wanting to turn the centered positioned sail.

>turn the sail right
You twist the mast slightly to the right.
centered positioned sail
There is a faint outline of an island in the distance.

>l
Journeying On The Waves (on the piece of wood)
A brisk northwestward wind is blowing. The sun hangs low in the sky. You speed ahead toward the island as the wind catches your fancy jacket-sail.

You can see a right positioned sail here.

The wind suddenly shifts to the northwestward! You speed ahead toward the island as the wind catches your fancy jacket-sail.

>turn sail left
You twist the mast slightly to the left.
right positioned sail

* * *

>w
You begin to paddle, but it has little effect. Better stick to sailing.

There is the faint outline of an island in the distance.

>l
Journeying On The Waves (on the piece of wood)
A brisk westward wind is blowing. The sun hangs low in the sky. You speed ahead toward the island as the wind catches your fancy jacket-sail.

You can see a centered positioned sail here.

The wind suddenly shifts to the westward! You speed ahead toward the island as the wind catches your fancy jacket-sail.

>turn sail right
You twist the mast slightly to the right.
3

>turn sail left
You twist the mast slightly to the left.
2
The wind suddenly shifts to the westward! You speed ahead toward the island as the wind catches your fancy jacket-sail.The island getting closer.

>l
Journeying On The Waves (on the piece of wood)
A brisk westward wind is blowing. The sun hangs low in the sky. You speed ahead toward the island as the wind catches your fancy jacket-sail.

You can see a centered positioned sail here.

The island getting closer.

>turn sail left
You twist the mast slightly to the left.
1
The wind suddenly shifts to the westward! Your speed toward the island has slowed to a crawl.The island getting closer.

>l
Journeying On The Waves (on the piece of wood)
A brisk westward wind is blowing. The sun hangs low in the sky. Your speed toward the island has slowed to a crawl.

You can see a left positioned sail here.

The island getting closer.

>turn sail left
You twist the mast slightly to the left.
0
The island getting closer.

>l
Journeying On The Waves (on the piece of wood)
A brisk westward wind is blowing. The sun hangs low in the sky. Your speed toward the island has slowed to a crawl.

You can see a left positioned sail here.

The island getting closer.

>turn sail left
You twist the mast slightly to the left.
-1
The wind suddenly shifts to the westward! Your speed toward the island has slowed to a crawl.The island getting closer.

>l
Journeying On The Waves (on the piece of wood)
A brisk westward wind is blowing. The sun hangs low in the sky. Your speed toward the island has slowed to a crawl.

You can see a left positioned sail here.

The island getting closer.

>turn sail right
You twist the mast slightly to the right.
0
The island getting closer.

>l
Journeying On The Waves (on the piece of wood)
A brisk southwestward wind is blowing. The sun hangs low in the sky. Your speed toward the island has slowed to a crawl.

You can see a left positioned sail here.

The island getting closer.

>turn sail right
You twist the mast slightly to the right.
1
The wind suddenly shifts to the southwestward! You speed ahead toward the island as the wind catches your fancy jacket-sail.

>l
Journeying On The Waves (on the piece of wood)
A brisk southwestward wind is blowing. The sun hangs low in the sky. You speed ahead toward the island as the wind catches your fancy jacket-sail.

You can see a left positioned sail here.

You've almost made it to the island.

>turn sail right
You twist the mast slightly to the right.
2
You've almost made it to the island.

>l
Journeying On The Waves (on the piece of wood)
A brisk southwestward wind is blowing. The sun hangs low in the sky. Your speed toward the island has slowed to a crawl.

You can see a centered positioned sail here.

You've almost made it to the island.

>turn sail right
You twist the mast slightly to the right.
3
You've almost made it to the island.

>l
Journeying On The Waves (on the piece of wood)
A brisk southwestward wind is blowing. The sun hangs low in the sky. Your speed toward the island has slowed to a crawl.

You can see a right positioned sail here.

You've almost made it to the island.

>turn sail left
You twist the mast slightly to the left.
2
The wind suddenly shifts to the southwestward! Your speed toward the island has slowed to a crawl.You've almost made it to the island.

>l
Journeying On The Waves (on the piece of wood)
A brisk southwestward wind is blowing. The sun hangs low in the sky. Your speed toward the island has slowed to a crawl.

You can see a centered positioned sail here.

You've almost made it to the island.

>turn sail left
You twist the mast slightly to the left.
1
The wind suddenly shifts to the westward! Your speed toward the island has slowed to a crawl.You've almost made it to the island.

>l
Journeying On The Waves (on the piece of wood)
A brisk westward wind is blowing. The sun hangs low in the sky. Your speed toward the island has slowed to a crawl.

You can see a left positioned sail here.

The wind suddenly shifts to the northwestward! Your speed toward the island has slowed to a crawl.You've almost made it to the island.

* * *

>get stick
Taken.

>put stick in knothole and put jacket on stick
I only understood you as far as wanting to put the stick in the knothole.

>put the stick in the knothole
You place the driftwood stick into the knothole. It's a tight fit, but you manage it. Your little plank surfboard now has a mast.

* * *

>l
Rushing Waves (on the piece of wood)
You rush along the tops of the waves as a westward wind blows your makeshift sail.  The sail is in the center position and the wind fills it nicely. The board is slippery and wet and hits the occasional wave just so, sending a spray into your face, almost knocking you from the board. You cling to the fragile looking stick of driftwood desperately hoping that it will hold and keep you on the board.

>l
Journeying On The Waves (on the piece of wood)
A brisk wind wind is blowing. The sun hangs low in the sky. In the distance you can barely make out the shape of an island jutting above the waves

You can see a sail here.

The wind suddenly shifts to the westward! You speed ahead toward the island as the wind catches your fancy jacket-sail.There is a faint outline of an island in the distance.

>l
Journeying On The Waves (on the piece of wood)
A brisk westward wind is blowing. The sun hangs low in the sky. You speed ahead toward the island as the wind catches your fancy jacket-sail.

You can see a centered positioned sail here.

There is a faint outline of an island in the distance.

>l
Journeying On The Waves (on the piece of wood)
A brisk westward wind is blowing. The sun hangs low in the sky. You speed ahead toward the island as the wind catches your fancy jacket-sail.

You can see a centered positioned sail here.

The wind suddenly shifts to the westward! You speed ahead toward the island as the wind catches your fancy jacket-sail.

* * *

>l
Journeying On The Waves (on the piece of wood)
A brisk westward wind is blowing. The sun hangs low in the sky. You speed ahead toward the island as the wind catches your fancy jacket-sail.

You can see a centered positioned sail here.

>l
Journeying On The Waves (on the piece of wood)
A brisk southwestward wind is blowing. The sun hangs low in the sky. Your speed toward the island has slowed to a crawl.

You can see a centered positioned sail here.

* * *

>w
Rippling Waves
....  You see a piece of wood about six feet in length. You swim over and cling to it gratefully. You look at the wood, and a surge of hope goes through you. This is actually a wide board that has been roughly hewn from a log.

You can see a piece of wood here.

You deeply regret trying to stop your phone from falling over the railing of the ship. Now look what's happened.

What next?  You can say, help, to get more information on how to play.

>get on wood.
Thank goodness!  You were getting exhausted just trying to stay alfloat.

>l
Rippling Waves
 You see a piece of wood about six feet in length. You swim over and cling to it gratefully. You look at the wood, and a chill goes through you. This is actually a board that has been roughly hewn from log.

You can see a piece of wood here.

* * *

>w
Rippling Waves
....  You see a piece of wood about six feet in length. You swim over and cling to it gratefully. You look at the wood, and a surge of hope goes through you. This is actually a wide board that has been roughly hewn from a log.

You can see a piece of wood here.

You deeply regret trying to stop your phone from falling over the railing of the ship. Now look what's happened.

What next?  You can say, help, to get more information on how to play.

>get on would
Thank goodness!  You were getting exhausted just trying to stay alfloat.

You mount the piece of wood.

>e
Ocean Waves (on the piece of wood)
 The water laps at the plank you sit on, rocking you up and down.  A dark object bobs up and down on the surface to the North.

* * *

>l
Journeying On The Waves (on the piece of wood)
A brisk westward wind is blowing. The sun hangs low in the sky. You speed ahead toward the island as the wind catches your fancy jacket-sail.

You can see a centered positioned sail here.

There is the faint outline of an island in the distance.

>l
Journeying On The Waves (on the piece of wood)
A brisk westward wind is blowing. The sun hangs low in the sky. You speed ahead toward the island as the wind catches your fancy jacket-sail.

You can see a centered positioned sail here.

The wind suddenly shifts to the westward! You speed ahead toward the island as the wind catches your fancy jacket-sail.

* * *

>l
Journeying On The Waves (on the piece of wood)
A brisk northwestward wind is blowing. The sun hangs low in the sky. Your speed toward the island has slowed to a crawl.

You can see a centered positioned sail here.

>turn sale right
You twist the mast slightly to the right.
centered positioned sail
The island is getting closer.

>l
Journeying On The Waves (on the piece of wood)
A brisk northwestward wind is blowing. The sun hangs low in the sky. You speed ahead toward the island as the wind catches your fancy jacket-sail.

You can see a right positioned sail here.

The island is getting closer.

>l
Journeying On The Waves (on the piece of wood)
A brisk northwestward wind is blowing. The sun hangs low in the sky. You speed ahead toward the island as the wind catches your fancy jacket-sail.

You can see a right positioned sail here.

The wind suddenly shifts to the northwestward! You speed ahead toward the island as the wind catches your fancy jacket-sail.

>l
Journeying On The Waves (on the piece of wood)
A brisk northwestward wind is blowing. The sun hangs low in the sky. You speed ahead toward the island as the wind catches your fancy jacket-sail.

You can see a right positioned sail here.

>l
Journeying On The Waves (on the piece of wood)
A brisk southwestward wind is blowing. The sun hangs low in the sky. Your speed toward the island has slowed to a crawl.

You can see a right positioned sail here.

>l
Journeying On The Waves (on the piece of wood)
A brisk southwestward wind is blowing. The sun hangs low in the sky. Your speed toward the island has slowed to a crawl.

You can see a right positioned sail here.

>l
Journeying On The Waves (on the piece of wood)
A brisk southwestward wind is blowing. The sun hangs low in the sky. Your speed toward the island has slowed to a crawl.

You can see a right positioned sail here.

The wind suddenly shifts to the southwestward! Your speed toward the island has slowed to a crawl.

>turn sail left
You twist the mast slightly to the left.
right positioned sail

>turn sail left
You twist the mast slightly to the left.
centered positioned sail

>l
Journeying On The Waves (on the piece of wood)
A brisk northwestward wind is blowing. The sun hangs low in the sky. Your speed toward the island has slowed to a crawl.

You can see a left positioned sail here.

The wind suddenly shifts to the northwestward! Your speed toward the island has slowed to a crawl.

>turn sail right
You twist the mast slightly to the right.
left positioned sail
You've almost made it to the island.

>turn sail right
You twist the mast slightly to the right.
centered positioned sail
You've almost made it to the island.

A grey fin emerges from the waves.  Your adrenaline kicks in, but you manage to hold yourself together.  You guide your make-shift sailboard away from it until the fin submerges.

>l
Journeying On The Waves (on the piece of wood)
A brisk westward wind is blowing. The sun hangs low in the sky. Your speed toward the island has slowed to a crawl.

You can see a right positioned sail here.

You've almost made it to the island.

A grey fin emerges from the waves.  Your adrenaline kicks in, but you manage to hold yourself together.  You guide your make-shift sailboard away from it until the fin submerges.

>turn sail left
You twist the mast slightly to the left.
right positioned sail
The wind suddenly shifts to the westward! You speed ahead toward the island as the wind catches your fancy jacket-sail.You've almost made it to the island.

A grey fin emerges from the waves.  Your adrenaline kicks in, but you manage to hold yourself together.  You guide your make-shift sailboard away from it until the fin submerges.

>l
Journeying On The Waves (on the piece of wood)
A brisk westward wind is blowing. The sun hangs low in the sky. You speed ahead toward the island as the wind catches your fancy jacket-sail.

You can see a centered positioned sail here.

You've almost made it to the island.

A grey fin emerges from the waves.  Your adrenaline kicks in, but you manage to hold yourself together.  You guide your make-shift sailboard away from it until the fin submerges.

>l
Journeying On The Waves (on the piece of wood)
A brisk southwestward wind is blowing. The sun hangs low in the sky. Your speed toward the island has slowed to a crawl.

You can see a centered positioned sail here.

You've almost made it to the island.

A grey fin emerges from the waves.  Your adrenaline kicks in, but you manage to hold yourself together.  You guide your make-shift sailboard away from it until the fin submerges.
The shark is too quick.  Eons of evolution has turned it into the perfect predator.  It smells your fear and in the blink of an eye it's over.

    *** You have been eaten. ***

Would you like to RESTART, RESTORE a saved game, QUIT or UNDO the last command?

>restart
You are floating in the middle of a tropical ocean.  You hoped that the cruise ship would notice you were missing, but it's been hours and hours, and no ship has appeared on the horizon.

Alien Shores
An Interactive Fiction by Keith B Phillips
Release 1 / Serial number 180907 / Inform 7 build 6M62 (I6/v6.33 lib 6/12N) SD

Ocean Waves
 You lay on your back in the warm water as the waves lift your body up and down rythmically.

>w
Rippling Waves
 You see a piece of wood about six feet in length. You swim over and cling to it gratefully. You look at the wood, and a surge of hope goes through you. This is actually a board that has been roughly hewn from a log.

You can see a piece of wood here.

You deeply regret trying to stop your phone from falling over the railing of the ship.  Now look what's happened.

>get on wood
Thank goodness!  You were getting exhausted just trying to stay alfloat.

You mount the piece of wood.

* * *

>n
Floating Object (on the piece of wood)
 A body seems to have been the source of a partial meal.

On the body is a jacket.

>get all
jacket: The body is badly decayed. You can't tell if it was male or female.  Your stomach churns from the smell, but you grit your teeth and strip the jacket off.
knife: Taken.

* * *

>l
Journeying On The Waves (on the piece of wood)
A brisk westward wind is blowing. The sun hangs low in the sky. You speed ahead toward the island as the wind catches your fancy jacket-sail.

You can see a centered positioned sail here.

The wind suddenly shifts to the westward! You speed ahead toward the island as the wind catches your fancy jacket-sail.

>l
Journeying On The Waves (on the piece of wood)
A brisk westward wind is blowing. The sun hangs low in the sky. You speed ahead toward the island as the wind catches your fancy jacket-sail.

You can see a centered positioned sail here.

The island is getting closer.

>l
Journeying On The Waves (on the piece of wood)
A brisk westward wind is blowing. The sun hangs low in the sky. You speed ahead toward the island as the wind catches your fancy jacket-sail.

You can see a centered positioned sail here.

The wind suddenly shifts to the westward! You speed ahead toward the island as the wind catches your fancy jacket-sail.The island is getting closer.

>l
Journeying On The Waves (on the piece of wood)
A brisk westward wind is blowing. The sun hangs low in the sky. You speed ahead toward the island as the wind catches your fancy jacket-sail.

You can see a centered positioned sail here.

The island is getting closer.

>l
Journeying On The Waves (on the piece of wood)
A brisk northwestward wind is blowing. The sun hangs low in the sky. Your speed toward the island has slowed to a crawl.

You can see a centered positioned sail here.

The island is getting closer.

>l
Journeying On The Waves (on the piece of wood)
A brisk northwestward wind is blowing. The sun hangs low in the sky. Your speed toward the island has slowed to a crawl.

You can see a centered positioned sail here.

The island is getting closer.

>l
Journeying On The Waves (on the piece of wood)
A brisk northwestward wind is blowing. The sun hangs low in the sky. Your speed toward the island has slowed to a crawl.

You can see a centered positioned sail here.

The wind suddenly shifts to the northwestward! Your speed toward the island has slowed to a crawl.The island is getting closer.

>l
Journeying On The Waves (on the piece of wood)
A brisk northwestward wind is blowing. The sun hangs low in the sky. Your speed toward the island has slowed to a crawl.

You can see a centered positioned sail here.

The wind suddenly shifts to the southwestward! Your speed toward the island has slowed to a crawl.The island is getting closer.

>l
Journeying On The Waves (on the piece of wood)
A brisk southwestward wind is blowing. The sun hangs low in the sky. Your speed toward the island has slowed to a crawl.

You can see a centered positioned sail here.

The island is getting closer.

>l
Journeying On The Waves (on the piece of wood)
A brisk northwestward wind is blowing. The sun hangs low in the sky. Your speed toward the island has slowed to a crawl.

You can see a centered positioned sail here.

The wind suddenly shifts to the northwestward! Your speed toward the island has slowed to a crawl.The island is getting closer.

>l
Journeying On The Waves (on the piece of wood)
A brisk northwestward wind is blowing. The sun hangs low in the sky. Your speed toward the island has slowed to a crawl.

You can see a centered positioned sail here.

The island is getting closer.

>turn sail right
You twist the mast slightly to the right.
centered positioned sail
The island is getting closer.

>l
Journeying On The Waves (on the piece of wood)
A brisk southwestward wind is blowing. The sun hangs low in the sky. Your speed toward the island has slowed to a crawl.

You can see a right positioned sail here.

The island is getting closer.

>turn sail left
You twist the mast slightly to the left.
right positioned sail
The wind suddenly shifts to the southwestward! Your speed toward the island has slowed to a crawl.The island is getting closer.

>turn sail left
You twist the mast slightly to the left.
centered positioned sail
A grey fin emerges from the waves.  Your adrenaline kicks in, but you manage to hold yourself together.  You guide your make-shift sailboard away from it until the fin submerges.

>l
Journeying On The Waves (on the piece of wood)
A brisk southwestward wind is blowing. The sun hangs low in the sky. You speed ahead toward the island as the wind catches your fancy jacket-sail.

You can see a left positioned sail here.

The wind suddenly shifts to the southwestward! You speed ahead toward the island as the wind catches your fancy jacket-sail.You've almost made it to the island.

A grey fin emerges from the waves.  Your adrenaline kicks in, but you manage to hold yourself together.  You guide your make-shift sailboard away from it until the fin submerges.

>l
Journeying On The Waves (on the piece of wood)
A brisk southwestward wind is blowing. The sun hangs low in the sky. You speed ahead toward the island as the wind catches your fancy jacket-sail.

You can see a left positioned sail here.

You've almost made it to the island.

A grey fin emerges from the waves.  Your adrenaline kicks in, but you manage to hold yourself together.  You guide your make-shift sailboard away from it until the fin submerges.

>l
Journeying On The Waves (on the piece of wood)
A brisk northwestward wind is blowing. The sun hangs low in the sky. Your speed toward the island has slowed to a crawl.

You can see a left positioned sail here.

You've almost made it to the island.

A grey fin emerges from the waves.  Your adrenaline kicks in, but you manage to hold yourself together.  You guide your make-shift sailboard away from it until the fin submerges.

>turn sail right
You twist the mast slightly to the right.
left positioned sail
You've almost made it to the island.

A grey fin emerges from the waves.  Your adrenaline kicks in, but you manage to hold yourself together.  You guide your make-shift sailboard away from it until the fin submerges.
The shark is too quick.  Eons of evolution has turned it into the perfect predator.  It smells your fear and in the blink of an eye it's over.

    *** You have been eaten. ***

Would you like to RESTART, RESTORE a saved game, QUIT or UNDO the last command?

* * *

>w
Rippling Waves
....  You see a piece of wood about six feet in length. You swim over and cling to it gratefully. You look at the wood, and a surge of hope goes through you. This is actually a wide board that has been roughly hewn from a log.

You can see a piece of wood here.

You deeply regret trying to stop your phone from falling over the railing of the ship. Now look what's happened.

What next?  You can say, help, to get more information on how to play.

>get onwood
You can't see any such thing.

What next?

>get on wood
Thank goodness!  You were getting exhausted just trying to stay a float.

You mount the piece of wood.

What next?

>get bug
You can't see any such thing.

What next?

>e
Ocean Waves (on the piece of wood)
....  The water laps at the plank you sit on, rocking you up and down. You can see a dark object bobbing on the surface to the North.

You can see a bug here.

What next?

>get bug
White Sand Beach
.... You are on a beautiful island beach. To the east there is nothing but ocean for as far as the eye can see. This white sand beach extends north and south.  To the west is a lush jungle of green vegetation.

You can see a palm tree here.

Your stomach aches with hunger. You better find something to eat soon.

What next?

>s
South Beach
.... You are on the beach a little south from where you came ashore.  You can see your sailboard to the north. The surf washes over the sand with a sigh and hiss. The jungle is to the west and there is a little pool of water to the west from which a narrow stream of water flows out into the ocean.

What next?

* * *

>w
Lagoon
.... There is a small pool of water about twenty feet in diameter here. It appears to be fed by a stream flowing out of the jungle in the west. The water is so crystal clear that you can easily see the bottom. In the pool, several fish of varying sizes and spectacular colors swim leisurely about in the warm water.

You can see a pool (in which are an Ono, an Akule and a Monchong) here.

What next?

>get Ono.
I don't suppose the Ono would care for that.

What next?

>get Akule
I don't suppose the Akule would care for that.

What next?

>get Monchong
I don't suppose the Monchong would care for that.

What next?

* * *

>w
Rippling Waves
....  You see a piece of wood about six feet in length. You swim over and cling to it gratefully. You look at the wood, and a surge of hope goes through you. This is actually a wide board that has been roughly hewn from a log.

You can see a piece of wood here.

You deeply regret trying to stop your phone from falling over the railing of the ship. Now look what's happened.

What next?  You can say, help, to get more information on how to play.

>get wood
You can't hold the piece of wood and swim. You can barely stay above water as it is.

This really sucks. You could be kicking back right now having an ice-cold drink in the ship's lounge.

What next?

>e
Ocean Waves
....  You lay on your back in the warm water as your body floats up and down the rythmic waves. The hot sun beats down on you and there is not a cloud in the clear blue sky.  Say look, or north, east, west south to move.

You can see a bug here.

At least one good thing has come of all this, you won't have to worry about ending your vacation any time soon.

What next?  You can say, help, to get more information on how to play.

>get bug
You can't hold the bug and swim. You can barely stay above water as it is.

What next?  You can say, help, to get more information on how to play.

>l
Ocean Waves
....  You lay on your back in the warm water as your body floats up and down the rythmic waves. The hot sun beats down on you and there is not a cloud in the clear blue sky. 

You can see a bug here.

What next?  You can say, help, to get more information on how to play.

>get bug
You can't hold the bug and swim. You can barely stay above water as it is.

What next?  You can say, help, to get more information on how to play.

>w
Rippling Waves
....  You see a piece of wood about six feet in length. You swim over and cling to it gratefully. You look at the wood, and a surge of hope goes through you. This is actually a wide board that has been roughly hewn from a log.

You can see a piece of wood here.

What next?

>get on wood
Thank goodness!  You were getting exhausted just trying to stay a float.

You mount the piece of wood.

What next?

* * *

>w
Lagoon
.... There is a small pool of water about twenty feet in diameter here. It appears to be fed by a stream flowing out of the jungle in the west. The water is so crystal clear that you can easily see the bottom. In the pool, several fish of varying sizes and spectacular colors swim leisurely about in the warm water.

You can see a pool (in which are a yellow fish, a speckled fish and a striped fish) here.

What next?

>look at yellow fish
This fish is silver on the bottom and has a light green back with a yellow stripe along its sides.

What next?

>look at speckled fish
This fish is narrow and is the shape of a pie plate with fins. It's covered with black and silver scales

What next?

>look at striped fish
This is a fish about a foot long and has silver and black vertical stripes.  It has a long sharp snout.

What next?

* * *

>get wood
You can't hold the piece of wood and swim. You can barely stay above water as it is.

This really sucks. You could be kicking back right now having an ice-cold drink in the ship's lounge.

What next?

>get on wood
You mount the piece of wood.

* * *

>examine sail
You see nothing special about the sail.

>look at sail position
You can't see any such thing.

>examine sail
You see nothing special about the sail.

* * *

>w
Rippling Waves
....  You see a piece of wood about six feet in length. You swim over and cling to it gratefully. You look at the wood, and a surge of hope goes through you. This is actually a wide board that has been roughly hewn from a log.

You can see a piece of wood here.

You deeply regret trying to stop your phone from falling over the railing of the ship. Now look what's happened.

What next?  You can say, help, to get more information on how to play.

>l
Rippling Waves
 You see a piece of wood about six feet in length. You swim over and cling to it gratefully. You look at the wood, and a surge of hope goes through you. This is actually a board that has been roughly hewn from a log.

You can see a piece of wood here.

>get on wood
You mount the piece of wood.

>l
Rippling Waves (on the piece of wood)
 You are sitting on a rough board about six feet in length. All around you is ocean and sky.

>e
Ocean Waves (on the piece of wood)
 The water laps at the plank you sit on, rocking you up and down.  A dark object bobs up and down on the surface to the North.

>look at wood
It's a sturdy plank with round knothole in the middle of it.

I beg your pardon?

>n
Floating Object (on the piece of wood)
 A body seems to have been the source of a partial meal.

On the body is a jacket.

* * *

>l
Rushing Waves (on the piece of wood)
You rush along the tops of the waves as a westward wind blows your makeshift sail.  The sail is in the center position and the wind fills it nicely. The board is slippery and wet and hits the occasional wave just so, sending a spray into your face, almost knocking you from the board. You cling to the fragile looking stick of driftwood desperately hoping that it will hold and keep you on the board.

>l
Journeying On The Waves (on the piece of wood)
A brisk wind wind is blowing. The sun hangs low in the sky. In the distance you can see the faint outline of an island. Island

You can see a sail here.

You can see the faint outline of an island in the distance.

>l
Journeying On The Waves (on the piece of wood)
A brisk westward wind is blowing. The sun hangs low in the sky. In the distance you can see the faint outline of an island. You speed ahead toward the island as the wind catches your fancy jacket-sail.

You can see a centered positioned sail here.

You can see the faint outline of an island in the distance.

>l
Journeying On The Waves (on the piece of wood)
A brisk westward wind is blowing. The sun hangs low in the sky. In the distance you can see the faint outline of an island. You speed ahead toward the island as the wind catches your fancy jacket-sail.

You can see a centered positioned sail here.

>l
Journeying On The Waves (on the piece of wood)
A brisk westward wind is blowing. The sun hangs low in the sky. In the distance you can see the faint outline of an island. You speed ahead toward the island as the wind catches your fancy jacket-sail.

You can see a centered positioned sail here.

The wind suddenly shifts to the westward! You speed ahead toward the island as the wind catches your fancy jacket-sail.You see the island getting closer.

>w
You begin to paddle but seem to be getting nowhere.

You see the island getting closer.

>l
Journeying On The Waves (on the piece of wood)
A brisk westward wind is blowing. The sun hangs low in the sky. In the distance you can see the faint outline of an island. You speed ahead toward the island as the wind catches your fancy jacket-sail.

You can see a centered positioned sail here.

>l
Journeying On The Waves (on the piece of wood)
A brisk westward wind is blowing. The sun hangs low in the sky. In the distance you can see the faint outline of an island. You speed ahead toward the island as the wind catches your fancy jacket-sail.

You can see a centered positioned sail here.

You've almost made it to the island.

>l
Journeying On The Waves (on the piece of wood)
A brisk westward wind is blowing. The sun hangs low in the sky. In the distance you can see the faint outline of an island. You speed ahead toward the island as the wind catches your fancy jacket-sail.

You can see a centered positioned sail here.

The wind suddenly shifts to the westward! You speed ahead toward the island as the wind catches your fancy jacket-sail.You've almost made it to the island.

>l
Journeying On The Waves (on the piece of wood)
A brisk westward wind is blowing. The sun hangs low in the sky. In the distance you can see the faint outline of an island. You speed ahead toward the island as the wind catches your fancy jacket-sail.

You can see a centered positioned sail here.

The wind suddenly shifts to the southwestward! Your speed toward the island has slowed to a crawl.You've almost made it to the island.

>l
Journeying On The Waves (on the piece of wood)
A brisk southwestward wind is blowing. The sun hangs low in the sky. In the distance you can see the faint outline of an island. Your speed toward the island has slowed to a crawl.

You can see a centered positioned sail here.

You've almost made it to the island.

>l
Journeying On The Waves (on the piece of wood)
A brisk northwestward wind is blowing. The sun hangs low in the sky. In the distance you can see the faint outline of an island. Your speed toward the island has slowed to a crawl.

You can see a centered positioned sail here.

The wind suddenly shifts to the northwestward! Your speed toward the island has slowed to a crawl.You've almost made it to the island.

>l
Journeying On The Waves (on the piece of wood)
A brisk northwestward wind is blowing. The sun hangs low in the sky. In the distance you can see the faint outline of an island. Your speed toward the island has slowed to a crawl.

You can see a centered positioned sail here.

You've almost made it to the island.

>turn sail left
You twist the mast slightly to the left.
centered positioned sail
You've almost made it to the island.

>l
Journeying On The Waves (on the piece of wood)
A brisk westward wind is blowing. The sun hangs low in the sky. In the distance you can see the faint outline of an island. Your speed toward the island has slowed to a crawl.

You can see a left positioned sail here.

The wind suddenly shifts to the westward! Your speed toward the island has slowed to a crawl.You've almost made it to the island.

>l
Journeying On The Waves (on the piece of wood)
A brisk westward wind is blowing. The sun hangs low in the sky. In the distance you can see the faint outline of an island. Your speed toward the island has slowed to a crawl.

You can see a left positioned sail here.

>l
Island Beach (on the piece of wood)
You are on a beautiful island beach.

* * *

>restart
Are you sure you want to restart?

>y
You were a lowly ensign serving aboard the starship Venture when suddenly the alarm sounded.  You felt the ship lurch and buck while you ran to the nearest escape pod, but something went horribly wrong.  Before you could safely strap into your acceleration couch, a large explosion cast you about the pod and you hit your head hard. The last thing you remember is hearing frantic pleas for help over the radio.  Unkown hours later you regain consciousness, floating in the middle of a tropical ocean on an alien world.

Alien Shores
An Interactive Fiction by Keith B Phillips
Release 1 / Serial number 180905 / Inform 7 build 6M62 (I6/v6.33 lib 6/12N) SD

Ocean Waves
 You lay on your back in the warm water as the waves lift your body up and down rythmically.  The sun's relentless heat beats down on you and the salt spray stings your eyes. The sea laps against your face and sometimes over it.  When it does, you spout like a tiny human whale.

>n
Floating Object
 You tread water to stay afloat. You're getting tired.  A body seems to have been the source of a partial meal.

On the body is a jacket.

* * *

>s
Ocean Waves
 You lay on your back in the warm water as the waves lift your body up and down rythmically.  The sun's relentless heat beats down on you and the salt spray stings your eyes. The sea laps against your face and sometimes over it.  When it does, you spout like a tiny human whale.

>w
Rippling Waves
 You see a piece of wood about six feet in length. You swim over and cling to it gratefully. You look at the wood, and a chill goes through you. This is actually a board that has been roughly hewn from log.

You can see a piece of wood here.

>get on wood
You mount the piece of wood.

>n
You begin to paddle in that direction but without a plan or destination you soon lose hope and return.

>e
Ocean Waves (on the piece of wood)
 The water laps at the plank you sit on, rocking you up and down.  A dark object bobs up and down on the surface to the North.

* * *

>put stick in knothole
You place the driftwood stick into the knothole. It's a tight fit, but you manage it. Your little plank surfboard now has a mast.

>put jacket on stick.
You drape the jacket over the stick by the collar.
The wind catches the jacket and pulls you along over the waves.

Rushing Waves (on the piece of wood)
You rush along the tops of the waves as a westward wind blows your makeshift sail.  The sail is in the center position and the wind fills it nicely. The board is slippery and wet and hits the occasional wave just so, sending a spray into your face, almost knocking you from the board. You cling to the fragile looking stick of driftwood desperately hoping that it will hold and keep you on the board.

>l
Rushing Waves (on the piece of wood)
You rush along the tops of the waves as a westward wind blows your makeshift sail.  The sail is in the center position and the wind fills it nicely. The board is slippery and wet and hits the occasional wave just so, sending a spray into your face, almost knocking you from the board. You cling to the fragile looking stick of driftwood desperately hoping that it will hold and keep you on the board.

>l
Journeying On The Waves (on the piece of wood)
A brisk wind wind is blowing. The sun hangs low in the sky. In the distance you can see the faint outline of an island. Island

You can see a sail here.

The wind suddenly shifts to the westward! You speed ahead toward the island as the wind catches your fancy jacket-sail.You can see the faint outline of an island in the distance.

>l
Journeying On The Waves (on the piece of wood)
A brisk westward wind is blowing. The sun hangs low in the sky. In the distance you can see the faint outline of an island. You speed ahead toward the island as the wind catches your fancy jacket-sail.

You can see a centered positioned sail here.

You can see the faint outline of an island in the distance.

>turn sail left
You twist the mast slightly to the left.
centered positioned sail
You can see the faint outline of an island in the distance.

>l
Journeying On The Waves (on the piece of wood)
A brisk westward wind is blowing. The sun hangs low in the sky. In the distance you can see the faint outline of an island. Your speed toward the island has slowed to a crawl.

You can see a left positioned sail here.

You can see the faint outline of an island in the distance.

>l
Journeying On The Waves (on the piece of wood)
A brisk westward wind is blowing. The sun hangs low in the sky. In the distance you can see the faint outline of an island. Your speed toward the island has slowed to a crawl.

You can see a left positioned sail here.

You can see the faint outline of an island in the distance.

>l
Journeying On The Waves (on the piece of wood)
A brisk westward wind is blowing. The sun hangs low in the sky. In the distance you can see the faint outline of an island. Your speed toward the island has slowed to a crawl.

You can see a left positioned sail here.

The wind suddenly shifts to the westward! Your speed toward the island has slowed to a crawl.You can see the faint outline of an island in the distance.

>l
Journeying On The Waves (on the piece of wood)
A brisk westward wind is blowing. The sun hangs low in the sky. In the distance you can see the faint outline of an island. Your speed toward the island has slowed to a crawl.

You can see a left positioned sail here.

>l
Journeying On The Waves (on the piece of wood)
A brisk southwestward wind is blowing. The sun hangs low in the sky. In the distance you can see the faint outline of an island. You speed ahead toward the island as the wind catches your fancy jacket-sail.

You can see a left positioned sail here.

You see the island getting closer.

>turn sail right
You twist the mast slightly to the right.
left positioned sail
You see the island getting closer.

>turn sail right
You twist the mast slightly to the right.
centered positioned sail
The wind suddenly shifts to the southwestward! Your speed toward the island has slowed to a crawl.You see the island getting closer.

>l
Journeying On The Waves (on the piece of wood)
A brisk southwestward wind is blowing. The sun hangs low in the sky. In the distance you can see the faint outline of an island. Your speed toward the island has slowed to a crawl.

You can see a right positioned sail here.

The wind suddenly shifts to the westward! Your speed toward the island has slowed to a crawl.You see the island getting closer.

>turn sail left
You twist the mast slightly to the left.
right positioned sail
The wind suddenly shifts to the westward! You speed ahead toward the island as the wind catches your fancy jacket-sail.You see the island getting closer.

>turn sail left
You twist the mast slightly to the left.
centered positioned sail
You see the island getting closer.

>l
Journeying On The Waves (on the piece of wood)
A brisk westward wind is blowing. The sun hangs low in the sky. In the distance you can see the faint outline of an island. Your speed toward the island has slowed to a crawl.

You can see a left positioned sail here.

You see the island getting closer.

>turn sail right
You twist the mast slightly to the right.
left positioned sail

>turn sail right
You twist the mast slightly to the right.
centered positioned sail
The wind suddenly shifts to the westward! Your speed toward the island has slowed to a crawl.

>l
Journeying On The Waves (on the piece of wood)
A brisk westward wind is blowing. The sun hangs low in the sky. In the distance you can see the faint outline of an island. Your speed toward the island has slowed to a crawl.

You can see a right positioned sail here.

>l
Journeying On The Waves (on the piece of wood)
A brisk westward wind is blowing. The sun hangs low in the sky. In the distance you can see the faint outline of an island. Your speed toward the island has slowed to a crawl.

You can see a right positioned sail here.

>lturn sail left
That's not a verb I recognise.

>turn sail left
You twist the mast slightly to the left.
right positioned sail
You've almost made it to the island.

>turn sail left
You twist the mast slightly to the left.
centered positioned sail
The wind suddenly shifts to the westward! Your speed toward the island has slowed to a crawl.You've almost made it to the island.

>l
Journeying On The Waves (on the piece of wood)
A brisk westward wind is blowing. The sun hangs low in the sky. In the distance you can see the faint outline of an island. Your speed toward the island has slowed to a crawl.

You can see a left positioned sail here.

The wind suddenly shifts to the southwestward! You speed ahead toward the island as the wind catches your fancy jacket-sail.You've almost made it to the island.

* * *

>l
Ocean Waves
 You lay on your back in the warm water as your body floats up and down the rythmic waves. The hot sun beats down on you and there is not a cloud in the clear blue sky.

>l
Ocean Waves
 You lay on your back in the warm water as your body floats up and down the rythmic waves. The hot sun beats down on you and there is not a cloud in the clear blue sky. 

You're getting so tired, and the waves are kicking up some in wind. You have to get out of the water soon.

>l
Ocean Waves
 You lay on your back in the warm water as your body floats up and down the rythmic waves. The hot sun beats down on you and there is not a cloud in the clear blue sky.

>l
Ocean Waves
 You lay on your back in the warm water as your body floats up and down the rythmic waves. The hot sun beats down on you and there is not a cloud in the clear blue sky. 

You are suddenly exhausted, you try to resume floating on your back again, but the waves are higher now and sweep you under.  You reach for the surface as you sink into the gloom.

    *** You have drowned. ***

Would you like to RESTART, RESTORE a saved game, QUIT or UNDO the last command?

* * *

>w
Rippling Waves
....  You see a piece of wood about six feet in length. You swim over and cling to it gratefully. You look at the wood, and a surge of hope goes through you. This is actually a wide board that has been roughly hewn from a log.

You can see a piece of wood here.

You deeply regret trying to stop your phone from falling over the railing of the ship. Now look what's happened.

What next?  You can say, help, to get more information on how to play.

>look at hole
The knothole is empty.

* * *

>w
Rippling Waves
....  You see a piece of wood about six feet in length. You swim over and cling to it gratefully. You look at the wood, and a surge of hope goes through you. This is actually a wide board that has been roughly hewn from a log.

You can see a piece of wood here.

You deeply regret trying to stop your phone from falling over the railing of the ship. Now look what's happened.

What next?  You can say, help, to get more information on how to play.

>ne
Floating Object
 You tread water to stay afloat. You're getting tired.  A body seems to have been the source of a partial meal.

On the body is a jacket.

>s
Ocean Waves
 You lay on your back in the warm water as the waves lift your body up and down rythmically.  The sun's relentless heat beats down on you and the salt spray stings your eyes. The sea laps against your face and sometimes over it.  When it does, you spout like a tiny human whale.

* * *

>get on wood
You mount the piece of wood.

>ne
Floating Object (on the piece of wood)
 A body seems to have been the source of a partial meal.

On the body is a jacket.

* * *

>l
Rushing Waves (on the piece of wood)
You rush along the tops of the waves as a westward wind blows your makeshift sail.  The sail is in the center position and the wind fills it nicely. The board is slippery and wet and hits the occasional wave just so, sending a spray into your face, almost knocking you from the board. You cling to the fragile looking stick of driftwood desperately hoping that it will hold and keep you on the board.

>w
You begin to paddle but seem to be getting nowhere.

The wind suddenly shifts to the westward! You speed ahead toward the island as the wind catches your fancy jacket-sail.

>l
Journeying On The Waves (on the piece of wood)
A brisk westward wind is blowing. The sun hangs low in the sky over a distant island. You speed ahead toward the island as the wind catches your fancy jacket-sail.

You can see a centered positioned sail here.

The wind suddenly shifts to the southwestward! Your speed toward the island has slowed to a crawl.

>l
Journeying On The Waves (on the piece of wood)
A brisk southwestward wind is blowing. The sun hangs low in the sky over a distant island. Your speed toward the island has slowed to a crawl.

You can see a centered positioned sail here.

>l
Journeying On The Waves (on the piece of wood)
A brisk northwestward wind is blowing. The sun hangs low in the sky over a distant island. Your speed toward the island has slowed to a crawl.

You can see a centered positioned sail here.

* * *

>turn sail right
You twist the mast slightly to the right.

The wind suddenly shifts to the westward! You speed ahead toward the island as the wind catches your fancy jacket-sail.

>turn sail right
You twist the mast slightly to the right.

The wind suddenly shifts to the westward! Your speed toward the island has slowed to a crawl.

>l
Journeying On The Waves (on the piece of wood)
A brisk westward wind is blowing. The sun hangs low in the sky over a distant island. Your speed toward the island has slowed to a crawl.

You can see a right positioned sail here.

* * *

>l
Journeying On The Waves (on the piece of wood)
A brisk southwestward wind is blowing. The sun hangs low in the sky over a distant island. Your speed toward the island has slowed to a crawl.

You can see a centered positioned sail here.

>turn sail right
You twist the mast slightly to the right.

* * *

>l
Journeying On The Waves (on the piece of wood)
A brisk southwestward wind is blowing. The sun hangs low in the sky over a distant island. Your speed toward the island has slowed to a crawl.

You can see a right positioned sail here.

>turn sail left
You twist the mast slightly to the left.

The wind suddenly shifts to the southwestward! Your speed toward the island has slowed to a crawl.

>turn sail left
You twist the mast slightly to the left.

The wind suddenly shifts to the southwestward! You speed ahead toward the island as the wind catches your fancy jacket-sail.

* * *

>l
Journeying On The Waves (on the piece of wood)
A brisk southwestward wind is blowing. The sun hangs low in the sky over a distant island. You speed ahead toward the island as the wind catches your fancy jacket-sail.

You can see a left positioned sail here.

>turn sail right
You twist the mast slightly to the right.

The wind suddenly shifts to the southwestward! Your speed toward the island has slowed to a crawl.

>turn sail right
You twist the mast slightly to the right.

* * *

>l
Island Beach (on the piece of wood)
You are on a beautiful island beach.

>turn sail left
You can't see any such thing.

>l
Island Beach (on the piece of wood)
You are on a beautiful island beach.

* * *

>w
Rippling Waves
....  You see a piece of wood about six feet in length. You swim over and cling to it gratefully. You look at the wood, and a surge of hope goes through you. This is actually a wide board that has been roughly hewn from a log.

You can see a piece of wood here.

You deeply regret trying to stop your phone from falling over the railing of the ship. Now look what's happened.

What next?  You can say, help, to get more information on how to play.

>w
You begin to paddle in that direction but without a plan or destination you soon lose hope and return.

This really sucks. You could be kicking back having an ice-cold drink in the ship's lounge right now.

>e
Ocean Waves
 You lay on your back in the warm water as your body floats up and down the rythmic waves. The hot sun beats down on you and there is not a cloud in the clear blue sky. 

Well, at least you won't have to worry about ending your vacation any time soon.

>e
Open Water
 You swim to stay afloat. All that effort is making you really tired. If only you had something to float on. Nothing but more ocean can be seen in all directions.

>n
Even More Open Water
 You swim to stay afloat. You're getting tired.  There is a stick of very wet driftwood here, about six feet long and and one inch thick.

>get stick
You can't hold the stick and swim. You can barely stay above water as it is.

>w
Glittering Waves
 You tread water, and you are getting exhausted.  What is left of a human body floats on the surface here.  Something has been eating on it.

On the body is a jacket.

>look at the body
The body floats face down.  Something has taken a chunk out of its side.

On the body is a jacket.

>get jacket
You can't hold the jacket and swim. You can barely stay above water as it is.

>s
Ocean Waves
 You lay on your back in the warm water as your body floats up and down the rythmic waves. The hot sun beats down on you and there is not a cloud in the clear blue sky. 

You're getting so tired, and the waves are kicking up some in wind. You have to get out of the water soon.

>s
More Open Water
 You tread water to stay afloat. You're getting tired.  Nothing but more ocean can be seen in all directions.

* * *

>wait
Time passes.

You deeply regret trying to stop your phone from falling over the railing of the ship. Now look what's happened.

What next?  You can say, help, to get more information on how to play.